出征收	出征收
八蜡	八蜡
一面食	一面食
嬖幸	嬖倖
著緊	着緊
对表扬	對表揚
于欣	于欣
流著述	流著述
合府上	合府上
场	場
圹	壙
不干犯	不干犯
背著名	背著名
并存着	並存著
锦绣花园	錦綉花園
圈子里	圈子裡
圣	聖
时间里	時間裡
恋恋不舍	戀戀不捨
于行	於行
争	爭
六出口	六出口
想著錄	想著錄
亏	虧
于	於
云	雲
髭著	髭着
亚	亞
凶猛	兇猛
爭著名	爭著名
注疏	註疏
产	產
６天后	６天後
亩	畝
于帥	于帥
瞪著	瞪着
检	檢
棁	梲
棂	欞
亲	親
亵	褻
古语云	古語云
抱著	抱着
席卷	席捲
亿	億
奇丑	奇醜
雅著述	雅著述
横杆	橫杆
托辞	託辭
懷著述	懷著述
渴著名	渴著名
藝著書	藝著書
庄稼院	庄稼院
浒	滸
于洋	于洋
采买	採買
水里溪	水里溪
制备	製備
搭伙	搭夥
醜著者	醜著者
圆	圓
保险柜	保險柜
三统历	三統曆
涼著者	涼著者
７年	７年
㑩	儸
间不容发	間不容髮
村子裡	村子裏
秒表明	秒表明
小价	小价
家具体	家具體
郁郁	鬱郁
千只够	千只夠
二里头	二里頭
制著名	制著名
千只夠	千只夠
頁面	頁面
小仆	小僕
布谷	布穀
渴著書	渴著書
乔岳	喬嶽
泡制	泡製
托交	託交
穿著作	穿著作
站干岸儿	站乾岸兒
侵占	侵佔
騰格里	騰格里
冀著名	冀著名
贵价	貴价
千多只	千多隻
济	濟
征候	徵候
于震中	於震中
开吊	開弔
浍	澮
懈松	懈鬆
舍实	捨實
無言不仇	無言不讎
猜著作	猜著作
浈	湞
几榻	几榻
忍著述	忍著述
了然	瞭然
精干	精幹
庄语	莊語
去著者	去著者
斗合	鬥合
征招	徵招
裹著述	裹著述
有征服	有征服
斗上	鬥上
隔著書	隔著書
广部	广部
开辟	開闢
标注	標註
斗丽	鬥麗
扛著作	扛著作
任于	任於
伙友	夥友
夢著稱	夢著稱
敢干	敢幹
劳力士表	勞力士錶
達著作	達著作
一年里	一年裡
于康震	于康震
中型钟面	中型鐘面
反冲	反衝
咸味	鹹味
爭著書	爭著書
好斗	好鬥
笑著述	笑著述
干姊	乾姊
努著述	努著述
疑系	疑係
干姜	乾薑
揭丑	揭醜
夢有五不占	夢有五不占
陪吊	陪弔
爭著稱	爭著稱
擺著稱	擺著稱
竹几	竹几
哪里	哪裡
郑凯云	鄭凱云
乘著者	乘著者
石钟乳	石鐘乳
敞著名	敞著名
蓟	薊
形于	形於
蓝	藍
占稳	佔穩
蓠	蘺
蓦	驀
傻里傻气	傻裡傻氣
蓥	鎣
赵惠后	趙惠后
挑著述	挑著述
３年	３年
刮得	颳得
别着	別著
活著稱	活著稱
绪余	緒餘
瞞著錄	瞞著錄
打斗	打鬥
于佳卉	于佳卉
落著述	落著述
术	術
采砂场	採砂場
嬉游	嬉遊
吊腰撒跨	弔腰撒跨
机	機
被发缨冠	被髮纓冠
罩著錄	罩著錄
凶手	兇手
干血浆	乾血漿
人参酌	人參酌
豆腐干	豆腐乾
甚于	甚於
杨雅筑	楊雅筑
内斗	內鬥
掣签	掣籤
征名责实	徵名責實
三只	三隻
笑著書	笑著書
三周后	三周後
徐干	徐幹
𩖗	䫴
𩖖	顃
𩖕	𩓣
松了	鬆了
蜜里调油	蜜裡調油
斗而铸兵	鬥而鑄兵
郁悒	鬱悒
本著作	本著作
富余	富餘
耍斗	耍鬥
松些	鬆些
闷着头儿干	悶著頭兒幹
睡得著	睡得着
表链	錶鏈
砾	礫
砺	礪
砻	礱
卫后庄公	衛後莊公
无药可救	無藥可救
坚致	堅緻
面包住	面包住
吊喭	弔喭
砜	碸
钟表的	鐘錶的
不著痕跡	不着痕跡
砚	硯
砖	磚
砗	硨
辟谣	闢謠
绷着脸	繃著臉
只要功夫深，铁杵磨成锈花针	只要功夫深，鐵杵磨成鏽花針
砀	碭
码	碼
盘回	盤迴
叱咤樂壇	叱咤樂壇
點著書	點著書
落著錄	落著錄
任何钟表	任何鐘錶
幫著作	幫著作
烤晒	烤晒
斗雪红	鬥雪紅
溢著者	溢著者
恰才	恰纔
醜著錄	醜著錄
并流	併流
亸	嚲
短信	短訊
积谷	積穀
分散于	分散於
庆历	慶曆
向著作	向著作
于衷	於衷
髅	髏
盾著錄	盾著錄
于飞	于飛
两天后	兩天後
人参禅	人參禪
于小伟	于小偉
髌	髕
叶志穗	叶志穗
看著稱	看著稱
信托贸易	信托貿易
藏历	藏曆
巅	巔
匿于	匿於
立范	立範
圍著者	圍著者
万历	萬曆
躺著稱	躺著稱
免征	免徵
多冲	多衝
拗别	拗彆
挑著名	挑著名
丝织厂	絲織廠
夜游	夜遊
巩	鞏
巯	巰
䅉	稏
仆憎	僕憎
泽渗漓而下降	澤滲灕而下降
福著	福着
并行	並行
五出刊	五出刊
罵著	罵着
邀天之幸	邀天之倖
侍仆	侍僕
樯	檣
托附	託附
冬日里	冬日裡
回廊	迴廊
愿朴	愿樸
复种	複種
游了	遊了
范文虎	范文虎
羟	羥
冀著錄	冀著錄
摟著述	摟著述
手冢治虫	手塚治虫
濑	瀨
浑朴	渾樸
于右任	于右任
回向	迴向
作准	作準
占Ｄ	佔Ｄ
树梁	樹樑
霸占	霸佔
抑制作用	抑制作用
干白儿	乾白兒
干贝	乾貝
䞍	䝼
御寇	禦寇
蒙雾	濛霧
對著述	對著述
動著	動着
西岳	西嶽
于汉超	于漢超
干革命	幹革命
金表明	金表明
闯炼	闖鍊
披著書	披著書
地丑德齐	地醜德齊
撩斗	撩鬥
干货	乾貨
熊杰	熊杰
留发	留髮
只身上已	只身上已
揉著述	揉著述
直接参与	直接參与
干醋	乾醋
棱层	稜層
独占	獨佔
盛著作	盛著作
叱咤叱叱咤	叱咤叱叱咤
不断发	不斷發
丑史	醜史
聽著作	聽著作
瑶签	瑤籤
尋著述	尋著述
騙著作	騙著作
於夫羅	於夫羅
坦尚尼亞	坦桑尼亞
电子钟表	電子鐘錶
晒干	晒乾
杆子	杆子
斗别气	鬥彆氣
老面皮	老面皮
對著錄	對著錄
桑干	桑乾
窗明几亮	窗明几亮
仑背	崙背
吊客	弔客
丑逆	醜逆
准定	準定
评断发	評斷發
黃鈺筑	黃鈺筑
宏都拉斯	洪都拉斯
涼著書	涼著書
情欲	情慾
肥筑方言	肥筑方言
關著稱	關著稱
两周后	兩周後
唁吊	唁弔
㓥	劏
愈合	癒合
怀里	懷裡
译注	譯註
竖	豎
土豆	馬鈴薯
六个	六個
嚼谷	嚼穀
深山何处钟	深山何處鐘
一冲	一衝
瞞著名	瞞著名
蒙鸿	濛鴻
丑咤	醜吒
駕著作	駕著作
困兽之斗	困獸之鬥
复述	複述
老姜	老薑
拼著作	拼著作
王庄	王莊
扎好根	扎好根
孤著錄	孤著錄
揪发	揪髮
鸡丝面	雞絲麵
借箸代筹	藉箸代籌
訚	誾
昂著者	昂著者
舍车保帅	捨車保帥
冲口	衝口
肮脏	骯髒
𩧭	䭿
趴著	趴着
蒙头转	矇頭轉
韩制	韓製
吃辣面	吃辣麵
市占率	市佔率
面线	麵線
瞧着钟	瞧著鐘
拎著錄	拎著錄
这只采	這只採
馬格里布	馬格里布
雜著者	雜著者
扎脚	紮腳
诚朴	誠樸
浮著稱	浮著稱
大言非夸	大言非夸
账	賬
炼药	煉藥
于正昇	于正昇
焙干	焙乾
火药	火藥
于正昌	于正昌
义庄	義莊
蒙蒙懂懂	懞懞懂懂
松手	鬆手
三征七辟	三徵七辟
干女	乾女
印著	印着
恂栗	恂慄
采煤	採煤
并兼	併兼
穿著錄	穿著錄
言云	言云
历数	曆數
带团参加	帶團參加
钟漏	鐘漏
來著作	來著作
毛发	毛髮
追著名	追著名
索羅門群島	所羅門群島
并火	併火
姜黄	薑黃
仆吏	僕吏
追凶	追兇
山药	山藥
前面店	前面店
惩忿窒欲	懲忿窒欲
做著名	做著名
尽量克制	盡量剋制
暗著書	暗著書
新庄市	新莊市
小几	小几
才干政	才干政
任何表達	任何表達
硬干	硬幹
捉奸党	捉奸黨
药盒	藥盒
干球温度	幹球溫度
蕰	薀
蕲	蘄
厄瓜多爾	厄瓜多爾
于墙	於牆
方几	方几
活著者	活著者
奸宄	姦宄
烫面	燙麵
益于	益於
丑类	醜類
诱奸	誘姦
躍著作	躍著作
圍著作	圍著作
木杆	木杆
秀发	秀髮
可紧可松	可緊可鬆
注云	注云
囉囉苏苏	囉囉囌囌
于慎行	于慎行
記著書	記著書
颁	頒
吊唁	弔唁
面包厢	面包廂
颂	頌
占了卜	占了卜
繞著名	繞著名
药学	藥學
穷追不舍	窮追不捨
𪚐	𪘯
甘比亞	岡比亞
调制	調製
陇	隴
桨	槳
䴘	鷈
陈冲	陳冲
丑恶	醜惡
𪚏	𪘀
䴓	鳾
档	檔
桠	椏
騙著稱	騙著稱
䴗	鶪
桧	檜
䴕	鴷
䴔	鵁
涌上	湧上
额我略历史	額我略歷史
内面包的	內面包的
凶犯	兇犯
颛	顓
云為	云為
循著	循着
专辑里	專輯裡
漫著作	漫著作
向往时	向往時
曲车	麴車
求著	求着
伐罪吊民	伐罪弔民
于菟	於菟
向往日	向往日
纏著錄	纏著錄
台子	檯子
焖	燜
附著者	附著者
：克制	：剋制
凶杀	兇殺
笑著	笑着
天地志狼	天地志狼
驵	駔
驴	驢
驷	駟
求著錄	求著錄
驱	驅
驰	馳
驳	駁
驲	馹
驽	駑
圍著名	圍著名
驿	驛
碍	礙
驹	駒
驸	駙
驻	駐
䙓	襬
垄断价格	壟斷價格
周杰伦	周杰倫
䙊	𧜵
驭	馭
马	馬
碜	磣
驮	馱
表慢	錶慢
睡著錄	睡著錄
苍术	蒼朮
沤郁	漚鬱
铲平	剷平
成于	成於
丑月	丑月
碱	鹼
赈饥	賑饑
拉著稱	拉著稱
因著作	因著作
阿拉伯聯合大公國	阿拉伯聯合酋長國
掙著	掙着
托古讽今	託古諷今
几椅	几椅
于江震	于江震
斗闲气	鬥閑氣
干坏事	幹壞事
跳著稱	跳著稱
牽著稱	牽著稱
坤范	坤範
山岳	山嶽
冲盹	衝盹
染指于	染指於
辦著錄	辦著錄
接着说	接著說
漫游	漫遊
臨著者	臨著者
干涸	乾涸
心系神	心繫神
星巴克	星巴克
珍肴异馔	珍肴異饌
心系祖	心繫祖
坐著稱	坐著稱
干涩	乾澀
舍己为国	捨己為國
钟不扣不鸣	鐘不扣不鳴
征风召雨	徵風召雨
于1	於1
占R	佔R
于都县	于都縣
記著錄	記著錄
膠著	膠着
下签	下籤
任何表示	任何表示
袋里	袋裡
男用表	男用錶
占三	佔三
包庄	包莊
于7	於7
光致致	光緻緻
占世界	佔世界
催并	催併
一别头	一彆頭
世界里	世界裡
冲激	衝激
聘雇	聘僱
历书	曆書
模范三军	模范三軍
擦干净	擦乾淨
准噶尔	準噶爾
于余曲折	于餘曲折
盾著述	盾著述
并发现	並發現
余珍	餘珍
于震后	於震后
敞著稱	敞著稱
于蔭霖	于蔭霖
斗鱼	鬥魚
㶉	鸂
釉药	釉藥
占万	佔万
寄托在	寄托在
大风后	大風後
㶽	煱
干鲜	乾鮮
㶶	燶
国历来	國歷來
棒子面	棒子麵
刚干	剛乾
。克制	。剋制
保障著者	保障著者
精准	精準
吹著作	吹著作
黑色长发	黑色長髮
冲堂	衝堂
制钟	制鐘
姜茶	薑茶
克药	克藥
刻半钟	刻半鐘
仇仇	仇讎
于格	于格
分布于	分布於
網路	網絡
干坞	乾塢
干坤	乾坤
发钗	髮釵
點著述	點著述
载	載
药房	藥房
推舟于陆	推舟於陸
木制	木製
一出口	一出口
叫著書	叫著書
悫	愨
表厂	錶廠
樂著者	樂著者
悮	悞
悭	慳
悬	懸
不干牠	不干牠
方便面	方便麵
寒假裡	寒假裏
于洪区	于洪區
心系何	心繫何
心系选	心繫選
制成	製成
复决	複決
托大	託大
齐王舍牛	齊王捨牛
汤面	湯麵
录着	錄著
明目张胆	明目張胆
動著稱	動著稱
千个	千個
于归	于歸
复写	複寫
吊儿郎当	弔兒郎當
自制不	自制不
炆面	炆麵
格于	格於
在著錄	在著錄
髭著錄	髭著錄
心系你	心繫你
笨笨呆呆	笨笨呆呆
格瑞那達	格林納達
黏著稱	黏著稱
锏	鐧
锌	鋅
锍	鋶
打著書	打著書
锋	鋒
锈	銹
锉	銼
锆	鋯
锇	鋨
锄	鋤
锅	鍋
锂	鋰
锃	鋥
销	銷
锁	鎖
锞	錁
锟	錕
锜	錡
锝	鍀
锚	錨
锛	錛
锘	鍩
错	錯
锖	錆
锗	鍺
锔	鋦
锕	錒
锒	鋃
锓	鋟
锐	銳
锑	銻
键	鍵
锯	鋸
锬	錟
锭	錠
锪	鍃
锫	錇
锨	杴
锩	錈
锦	錦
锧	鑕
锤	錘
锥	錐
锢	錮
锣	鑼
锠	錩
不准	不準
锾	鍰
锿	鎄
锼	鎪
锽	鍠
锺	鍾
锻	鍛
锸	鍤
锹	鍬
陋著名	陋著名
锷	鍔
锴	鍇
锵	鏘
锲	鍥
锳	鍈
锰	錳
锱	錙
戏里	戲裡
去著	去着
各类钟	各類鐘
显著标志	顯著標志
卷袖	捲袖
冲破	衝破
與著稱	與著稱
理一个发	理一個髮
干这一行	幹這一行
丢丑	丟醜
结彩	結綵
于西翰	于西翰
心系风	心繫風
放蒙挣	放懞掙
犯不著錄	犯不著錄
嗅得著	嗅得着
用著書	用著書
叱咤MY903	叱咤MY903
于六	於六
跄	蹌
于八	於八
亿只	億隻
想著	想着
跃	躍
嵝	嶁
9只支援	9只支援
天后宫	天后宮
嵘	嶸
嵚	嶔
颁布	頒佈
跞	躒
林郁方	林郁方
叮当	叮噹
安胎药	安胎藥
数天后	數天後
夢著書	夢著書
干擦	乾擦
不通吊庆	不通弔慶
照著述	照著述
发踊冲冠	髮踊沖冠
闲	閑
𫛸	鶗
抓著作	抓著作
菠棱菜	菠稜菜
𫛶	鶒
拖著稱	拖著稱
灏	灝
兽欲	獸慾
𫛢	鸋
枕著者	枕著者
冥蒙	冥濛
轮奸	輪姦
蜂后	蜂后
灿	燦
灾	災
𫛞	鴃
周游	周遊
孤著者	孤著者
灵	靈
管著名	管著名
灯	燈
余力为	余力為
灭	滅
补血药	補血藥
于来山	于來山
雇农	僱農
于明涛	于明濤
嘤	嚶
书签	書籤
片言只语	片言隻語
小型钟表面	小型鐘表面
于永波	于永波
的钟	的鐘
嘱	囑
衣著者	衣著者
复列	複列
2只支援	2只支援
困觉	睏覺
这里	這裡
人参拜	人參拜
扞御	扞禦
大伙儿	大伙兒
主仆	主僕
发肤	髮膚
游玩	遊玩
于熙珍	于熙珍
七扎	七紮
发纱	髮紗
筑陽	筑陽
选手表达	選手表達
注上	註上
吊喉	弔喉
擋著述	擋著述
药丸	藥丸
殷师牛斗	殷師牛鬥
占英	佔英
药饵	藥餌
槠	櫧
著錄	着錄
犯不著作	犯不著作
槚	檟
槛	檻
钢梁	鋼樑
牽著述	牽著述
本著者	本著者
面包藏	面包藏
借著	借着
有只用	有只用
锦绣	錦繡
辦著作	辦著作
通于	通於
药专	藥專
歌后	歌后
1余	1餘
去著述	去著述
采生折割	採生折割
卷来	捲來
轉著名	轉著名
面人儿	麵人兒
于水	於水
不干涉	不干涉
５只	５隻
大钟	大鐘
信托	信託
美著錄	美著錄
少采	少採
自制下来	自制下來
于氏	于氏
斗富	鬥富
分别致	分别致
当家才知柴米价	當家纔知柴米價
壓著述	壓著述
能克制	能剋制
近角聰信	近角聰信
遇著書	遇著書
布谷鸟	布谷鳥
站著述	站著述
干吊着下巴	乾吊著下巴
睡著稱	睡著稱
占印	佔印
語著述	語著述
埃及历史	埃及歷史
迫著	迫着
桥梁	橋樑
太后	太后
信著書	信著書
舌干唇焦	舌乾唇焦
膠著作	膠著作
分布	分佈
人工智慧	人工智能
种师中	种師中
心系输	心繫輸
斥著述	斥著述
聊斋志异	聊齋志異
烫个发	燙個髮
于秀敏	于秀敏
有只采	有只採
占半	佔半
怎么	怎麼
丑三	丑三
占千	佔千
占十	佔十
游行	遊行
颤	顫
出卡通	齣卡通
覆亡	覆亡
游街	遊街
干的停当	幹的停當
直冲	直衝
鼻梁儿	鼻梁兒
自制她	自制她
美发	美髮
维系	維繫
称赞	稱讚
大折儿	大摺兒
冲心	衝心
班里	班裡
东游	東遊
天地为范	天地為範
上梁	上樑
賴比瑞亞	利比里亞
跟著	跟着
后髮星系團	后髮星系團
拧干	擰乾
桂圆干	桂圓乾
祷	禱
锅庄	鍋莊
模范21棒	模范21棒
绷子	繃子
于斯纳尔斯贝里	于斯納爾斯貝里
多只需	多只需
山洞里	山洞裡
窃钟掩耳	竊鐘掩耳
一并	一併
著涼	着涼
仆人	僕人
披著作	披著作
干瞪眼	乾瞪眼
天文学家	天文學家
迈克尔·舒马赫	舒麥加
釀著稱	釀著稱
甜水面	甜水麵
裡勾外連	裏勾外連
干亲	乾親
寫著述	寫著述
宴游	宴遊
祭吊	祭弔
秋日里	秋日裡
揮著作	揮著作
沙地阿拉伯	沙特阿拉伯
偷著者	偷著者
颊须	頰鬚
采桑	採桑
长生药	長生藥
快克制	快剋制
悠著稱	悠著稱
古钟表	古鐘錶
橱	櫥
𩏼	䪏
𩏽	𩏪
𩏾	𩎢
𩏿	䪘
旋回	旋迴
寡欲	寡慾
藓	蘚
华发	華髮
顛顛仆仆	顛顛仆仆
罢于	罷於
布雷，	佈雷，
几几	几几
于堅	于堅
閉著書	閉著書
布雷；	佈雷；
空著	空着
几凳	几凳
定制	定製
手表	手錶
只身首	只身首
几出	幾齣
于雙戈	于雙戈
奸污	姦汙
怜	憐
只身子	只身子
犯得著	犯得着
怅	悵
怄	慪
怆	愴
态	態
怀	懷
怃	憮
怂	慫
斥著稱	斥著稱
干刻版	乾刻版
整庄	整莊
后海湾	后海灣
拉著作	拉著作
怼	懟
怿	懌
祝发	祝髮
包括	包括
总	總
后印	後印
衣著	衣着
8只支援	8只支援
地志	地誌
网游	網遊
在著書	在著書
夺斗	奪鬥
南京钟	南京鐘
九世之仇	九世之讎
于玉立	于玉立
属于	屬於
趕著	趕着
并发布	並發布
	棡
炼石	鍊石
蓬蓬松松	蓬蓬鬆鬆
追著書	追著書
吃里爬外	吃裡爬外
帮	幫
懷著稱	懷著稱
數著稱	數著稱
皺著述	皺著述
于海上	於海上
布于	佈於
并发型模式	併發型模式
庄稼	莊稼
3周后	3周後
洗练	洗鍊
药医学系	藥醫學系
涵著者	涵著者
干洗	乾洗
强奸	強姦
荙	薘
扎寨	紮寨
星辰表	星辰錶
荛	蕘
干下去	幹下去
春日裡	春日裏
干活	幹活
笋	筍
只身邊	只身邊
踏著名	踏著名
蒙着	矇著
坐著書	坐著書
荐	薦
笃	篤
党参	党參
厮	廝
笔	筆
笕	筧
心系沈	心繫沈
刮风下雪倒便宜	刮風下雪倒便宜
缇	緹
党	黨
幫著錄	幫著錄
心系沙	心繫沙
并骨	併骨
笺	箋
笼	籠
笾	籩
仪表	儀錶
5只	5隻
劫余	劫餘
峄	嶧
扶余国	扶餘國
烬余	燼餘
困兽犹斗	困獸猶鬥
音声如钟	音聲如鐘
发匪	髮匪
棺材裡	棺材裏
峦	巒
峥	崢
峤	嶠
峣	嶢
坛騞	罈騞
峡	峽
印著名	印著名
于衡	于衡
丝布	絲布
辛巴威	津巴布韋
紧绷	緊繃
鸿篇巨制	鴻篇巨製
夸诞不经	夸誕不經
烧	燒
烦	煩
烩	燴
烨	燁
烫	燙
热	熱
烬	燼
游侠	遊俠
台历	枱曆
未干	未乾
叶　恭弘	叶　恭弘
划到江心	划到江心
帘布	帘布
候著述	候著述
拎著	拎着
雇到	僱到
鸡丝	雞絲
烁	爍
烃	烴
烂	爛
宽于	寬於
拉面具	拉面具
特效药	特效藥
国之桢干	國之楨榦
蓣	蕷
占超过	佔超過
烛	燭
皮里阳秋	皮裡陽秋
征士	徵士
诚征	誠徵
托名	託名
消炎药	消炎藥
陪著作	陪著作
对表示	對表示
言辩而确	言辯而确
来复	來複
丑丫头	醜丫頭
小伙子	小夥子
滨	濱
模范七棒	模范七棒
快干	快乾
赞不绝口	讚不絕口
采取	採取
鬼谷子	鬼谷子
眼帘	眼帘
出锤	出鎚
北岳	北嶽
由于	由於
钟的	鐘的
殺著	殺着
有余	有餘
好斗大	好斗大
打断发	打斷發
荪	蓀
荫	蔭
怫郁	怫鬱
漓然	灕然
盛著	盛着
咸汤	鹹湯
干隆	乾隆
接著者	接著者
击扑	擊扑
荦	犖
双折射	雙折射
师范	師範
杜老志道	杜老誌道
刑余	刑餘
应征	應徵
姜是老的辣	薑是老的辣
广舍	廣捨
所云云	所云云
自制情	自制情
聽著稱	聽著稱
映著作	映著作
日子裡	日子裏
捉奸	捉姦
不采声	不采聲
卷曲	捲曲
哭著錄	哭著錄
件钟	件鐘
百多只	百多隻
划桨	划槳
于澄	于澄
榴莲	榴槤
批复	批覆
一头长发	一頭長髮
透辟	透闢
印制	印製
丑人	醜人
旋干转坤	旋乾轉坤
占台	佔台
托管	託管
沉著錄	沉著錄
百只够	百只夠
鸠占鹊巢	鳩佔鵲巢
余三勝	余三勝
叱咤叱咤叱咤咤	叱咤叱咤叱咤咤
數著	數着
百只夠	百只夠
夏于乔	夏于喬
用著稱	用著稱
占取	佔取
复亩珍	複畝珍
冤仇	冤讎
丑事	醜事
旱干	旱乾
征收	徵收
蒲隆地	布隆迪
管干	管幹
朴念仁	樸念仁
6余	6餘
枕著稱	枕著稱
斩	斬
遠著述	遠著述
西晒	西晒
刘芸后	劉芸后
干躁	乾躁
须生	鬚生
弥弥	瀰瀰
性著述	性著述
干得	幹得
有只採	有只採
銮	鑾
回音	迴音
停停当当	停停當當
裝著稱	裝著稱
于勒	于勒
电子表	電子錶
法占	法佔
占多数	占多數
托咎	託咎
達著	達着
藏著書	藏著書
点里	點裡
只身后	只身後
张乐于张徐	張樂于張徐
儒略历	儒略曆
叶叶琹	葉叶琹
愛著稱	愛著稱
拼斗	拚鬥
谷梁	穀梁
樂著述	樂著述
大周后	大周后
落腮胡	落腮鬍
于勤	於勤
钢之炼金术师	鋼之鍊金術師
悲郁	悲鬱
喝著錄	喝著錄
韶山冲	韶山沖
領著	領着
并一不二	併一不二
吉布地	吉布堤
咙	嚨
看著錄	看著錄
划到	划到
辔	轡
泥于	泥於
采集	採集
制盐	製鹽
1只支持	1只支持
黄金表	黃金表
伴著書	伴著書
机械系	機械系
辙	轍
老仆	老僕
于小彤	于小彤
钢制	鋼製
楼	樓
３周后	３周後
辚	轔
横冲	橫衝
图	圖
犹	猶
下签名	下簽名
菜干	菜乾
剃须	剃鬚
黛安娜	戴安娜
閉著述	閉著述
采菊	採菊
瞞著作	瞞著作
回绕	迴繞
艰	艱
最多	最多
一干部下	一干部下
艺	藝
但云	但云
漓水	灕水
辅	輔
面灰	麵灰
复韵	複韻
囵	圇
賴索托	萊索托
晃著	晃着
守著錄	守著錄
4只支持	4只支持
瞅下钟	瞅下鐘
2只	2隻
心系她	心繫她
征验	徵驗
夸父	夸父
游猎	遊獵
心系奥	心繫奧
叫著作	叫著作
喾	嚳
低著錄	低著錄
只身上有	只身上有
夾著者	夾著者
喷	噴
余人	餘人
扛著錄	扛著錄
辊	輥
于心	於心
晒成	晒成
照相干片	照相乾片
苦里	苦裡
机械钟	機械鐘
一树百获	一樹百穫
于盲	於盲
7只	7隻
凶疑	兇疑
藤制	藤製
擦干	擦乾
燒著錄	燒著錄
座钟	座鐘
天后半	天後半
紧致	緊緻
枣庄	棗莊
方向往	方向往
臨著作	臨著作
于震环	于震環
团	團
語有云	語有云
旧游	舊遊
䌷	紬
百扎	百紮
挂面	挂面
机绣	機繡
戰著書	戰著書
宁	寧
该钟	該鐘
儒略改革历史	儒略改革歷史
辟邪以律	闢邪以律
戴著錄	戴著錄
公孙丑	公孫丑
秋天里	秋天裡
慣著錄	慣著錄
䌺	䋙
染发	染髮
宝	寶
实	實
宠	寵
审	審
鸣钟	鳴鐘
多只有	多只有
小只需	小只需
繁复	繁複
亚美尼亚历	亞美尼亞曆
多只會	多只會
宪	憲
美著	美着
獨著名	獨著名
家具有	家具有
电表	電錶
撤并	撤併
斗鹌鹑	鬥鵪鶉
宽	寬
宾	賓
印著稱	印著稱
于晨楠	于晨楠
整风后	整風後
咸鱼	鹹魚
斫雕为朴	斫雕為樸
简	簡
用著作	用著作
8只	8隻
忙里	忙裡
厄利垂亞	厄立特里亞
有著錄	有著錄
幸免于难	幸免於難
百只	百隻
降压药	降壓藥
缥	縹
悬挂	懸掛
前天	前天
４只	４隻
箦	簀
箧	篋
箪	簞
甜著作	甜著作
晃著錄	晃著錄
箩	籮
心系民	心繫民
希伯来历	希伯來曆
梳著	梳着
仗著錄	仗著錄
梦有五不占	夢有五不占
真个	真箇
夢著作	夢著作
并肩子	併肩子
尸魂界	尸魂界
钟口	鐘口
赞扬	讚揚
干着急	干著急
茎干	莖幹
桌历史	桌歷史
谒	謁
叱咤903	叱咤903
干警	幹警
朦胧	朦朧
鼻梁	鼻樑
巧干	巧幹
合准	合準
暑假裡	暑假裏
模制	模製
努力著述	努力著述
于树洁	于樹潔
并州	并州
扑冬冬	撲鼕鼕
伊达里子	伊達里子
征辟	徵辟
吐哺握发	吐哺握髮
佣金费用	佣金費用
胡里胡涂	胡裡胡塗
划艇	划艇
頂著者	頂著者
仆婢	僕婢
茶几	茶几
马占山	馬占山
征求	徵求
签押	籤押
尸祝	尸祝
制著書	制著書
戰著名	戰著名
须根据	須根據
发屋	髮屋
评注	評註
于靖	于靖
口里	口裡
余庆	餘慶
自制伏	自制伏
有栖川	有栖川
矮几	矮几
干花	乾花
月面	月面
荡平	蕩平
苍发	蒼髮
网志	網誌
雅著錄	雅著錄
有著名	有著名
騎著者	騎著者
自制力	自制力
偷著名	偷著名
鹤吊	鶴弔
載著者	載著者
郁挹	鬱挹
回递性	迴遞性
性著	性着
争奇斗妍	爭奇鬥妍
揉著稱	揉著稱
命中注定	命中注定
配著名	配著名
因著名	因著名
順著者	順著者
隨著者	隨著者
干父之蛊	幹父之蠱
衅	釁
記著述	記著述
对表	對錶
附著	附着
皆可作淀	皆可作澱
美著名	美著名
净发	淨髮
余烬	餘燼
余热	餘熱
批注	批註
盗采	盜採
冲坚陷阵	衝堅陷陣
存十一于千百	存十一於千百
淑范	淑範
包扎	包紮
魇	魘
魉	魎
于禁	于禁
厣	厴
心系摩	心繫摩
不准我	不准我
吊挂	弔掛
准的	準的
丰神	丰神
冲天	衝天
著手	着手
心系乔	心繫乔
壶里	壺裡
截发	截髮
金表达	金表達
洒然	洒然
背著稱	背著稱
動著述	動著述
咸卤	鹹鹵
黄历	黃曆
只身形	只身形
旧庄	舊庄
游刃有余	遊刃有餘
井干摧败	井榦摧敗
阴郁	陰鬱
只身影	只身影
松喉	鬆喉
被发佯狂	被髮佯狂
沿著述	沿著述
划子	划子
浮著作	浮著作
配著錄	配著錄
抽签	抽籤
著忙	着忙
八出刊	八出刊
開著	開着
钟敲	鐘敲
参与制	參與制
打著	打着
担担面	擔擔麵
六出逃	六出逃
丑诋	醜詆
向著	向着
干弟	乾弟
演著者	演著者
于远伟	于遠偉
丑侪	醜儕
蜡祭	蜡祭
丑话	醜話
獨著作	獨著作
一斗斗	一斗斗
幸运胡	幸運鬍
四出版	四出版
于前	於前
脏兮兮	髒兮兮
涵著作	涵著作
忙并	忙併
印著者	印著者
征信	徵信
蘸著書	蘸著書
𩠅	𩟐
讠	訁
𩠇	䭀
跌荡	跌蕩
讥	譏
认	認
讧	訌
讦	訐
让	讓
𩠌	餸
讫	訖
讪	訕
训	訓
𩠈	䭃
𩠋	𩝔
议	議
讱	訒
记	記
讳	諱
逆著	逆着
戀著	戀着
讴	謳
讷	訥
尋著名	尋著名
讹	訛
许	許
讻	訩
论	論
讽	諷
讼	訟
访	訪
设	設
占ｘ	佔ｘ
凶案	兇案
占ｚ	佔ｚ
抬著者	抬著者
属	屬
占ｐ	佔ｐ
动荡	動蕩
占ｒ	佔ｒ
占ｓ	佔ｓ
占ｔ	佔ｔ
占ｕ	佔ｕ
占ｖ	佔ｖ
占ｗ	佔ｗ
占ｈ	佔ｈ
占ｉ	佔ｉ
接著稱	接著稱
占ｋ	佔ｋ
占ｌ	佔ｌ
占ｍ	佔ｍ
占ｎ	佔ｎ
占ｏ	佔ｏ
占ａ	佔ａ
占ｂ	佔ｂ
占ｃ	佔ｃ
占ｄ	佔ｄ
占ｅ	佔ｅ
占ｆ	佔ｆ
占ｇ	佔ｇ
潤著者	潤著者
受著者	受著者
屿	嶼
干旱	乾旱
載著書	載著書
于幼军	于幼軍
牛只	牛隻
屡	屢
屦	屨
于从濂	于從濂
并拢	併攏
獭	獺
游伴	遊伴
千只怕	千只怕
官历史	官歷史
犯不著稱	犯不著稱
赞叹	讚歎
髋	髖
酒醴曲蘖	酒醴麴櫱
风后	風后
窑	窯
明征	明徵
庄子	莊子
醉于	醉於
䭪	𩞯
努力著名	努力著名
坐钟	坐鐘
占网	佔網
看表	看錶
仙后	仙后
睐	睞
禹余粮	禹餘糧
癸丑	癸丑
唢	嗩
唠	嘮
唡	啢
唤	喚
发已霜白	髮已霜白
能干	能幹
克制不住	剋制不住
准则	準則
脉冲	脈衝
余七	餘七
土里	土裡
唛	嘜
吁天	籲天
余三	餘三
唝	嗊
綁著述	綁著述
校准	校準
于海边	於海邊
谄	諂
余业	餘業
急著者	急著者
䲝	䱽
䲟	鮣
䲞	𩶘
來著稱	來著稱
准分子	準分子
藝著名	藝著名
系恋	繫戀
心系农	心繫农
借著者	借著者
心系故	心繫故
陋著稱	陋著稱
涂鸿钦	涂鴻欽
火并非	火並非
母后	母后
约占	約佔
云然	云然
彩牌楼	綵牌樓
絷	縶
手松	手鬆
干爹	乾爹
于爾岑	于爾岑
䲣	䱷
䲢	鰧
干爽	乾爽
待著錄	待著錄
涂药	塗藥
胎发	胎髮
備著錄	備著錄
臧谷亡羊	臧穀亡羊
几杖	几杖
女丑	女丑
含著作	含著作
会干扰	會干擾
戴表元	戴表元
庆历史	慶歷史
已占	已佔
下于	下於
亿多只	億多隻
忙著	忙着
九出逃	九出逃
个中高手	箇中高手
擋著	擋着
窭	窶
丰滨乡	豐濱鄉
开发	開發
畏于	畏於
稳扎	穩紮
響著述	響著述
盛著名	盛著名
丑地	醜地
龙斗虎伤	龍鬥虎傷
钟身	鐘身
漫著	漫着
因特网	互聯網
一划	一划
划得来	划得來
躺著者	躺著者
佣书	傭書
瞪著作	瞪著作
試著稱	試著稱
佛罗棱萨	佛羅稜薩
吃板刀面	吃板刀麵
借由	藉由
苎麻	苧麻
准保釋	准保釋
仆姑	僕姑
占至少	佔至少
重托	重託
照准	照準
戴表	戴錶
溢著	溢着
骀荡	駘蕩
够克制	夠剋制
科斗	科斗
雕悍	鵰悍
筑后	筑後
頂著錄	頂著錄
𦈖	䌈
坐庄	坐莊
遇著名	遇著名
冒著書	冒著書
腾冲	騰衝
半于	半於
信著者	信著者
面坯儿	麵坯兒
宝历史	寶歷史
雪裡蕻	雪裏蕻
阉	閹
阎	閻
扎成	紮成
載著述	載著述
配著者	配著者
愿而恭	愿而恭
愛著名	愛著名
睡著作	睡著作
苹萦	苹縈
懿范	懿範
并发症	併發症
阀	閥
划动	划動
蒙骗	矇騙
满头洋发	滿頭洋髮
巧历史	巧歷史
阆	閬
蓬松	蓬鬆
阇	闍
头发	頭髮
先占	先佔
赏赞	賞讚
西游	西遊
阅	閱
不托	不託
躯干	軀幹
疑著述	疑著述
空著者	空著者
四分历	四分曆
迫于	迫於
玮	瑋
了然后	了然後
性著名	性著名
揮著	揮着
队	隊
苋	莧
苈	藶
苎	苧
苏	蘇
苌	萇
苍	蒼
苁	蓯
苇	葦
殺著錄	殺著錄
疑著稱	疑著稱
响钟	響鐘
半只	半隻
春游	春遊
𪎌	麳
他克制	他剋制
采药	採藥
于斯達爾	于斯達爾
康著錄	康著錄
苧	薴
流著稱	流著稱
愠	慍
飏	颺
风	風
愦	憒
貞著述	貞著述
歹斗	歹鬥
布雷舰	佈雷艦
张勋	張勳
一干弟子	一干弟子
飚	飈
飙	飆
飘	飄
變著名	變著名
飓	颶
飒	颯
飑	颮
飐	颭
飗	飀
飖	颻
飕	颼
飔	颸
飨	饗
衣著作	衣著作
著墨	着墨
速食麵	即食麵
喧哄	喧鬨
承制	承製
余温	餘溫
南回线	南迴線
缩栗	縮慄
说着	說著
小周后	小周后
心系麦	心繫麥
里间	裡間
裝著書	裝著書
架钟	架鐘
流著	流着
占占	佔佔
只身心	只身心
這裡	這裏
魂牵梦系	魂牽夢繫
结伙	結夥
制纸	製紙
得著稱	得著稱
嚷著名	嚷著名
空蒙	空濛
心系他	心繫他
航海历	航海曆
械斗	械鬥
帮佣	幫傭
村子里	村子裡
五行生克	五行生剋
一争两丑	一爭兩醜
警报钟	警報鐘
并购	併購
洒扫	洒掃
封面里	封面裡
肚裡	肚裏
伤痕累累	傷痕纍纍
干渠	乾渠
沉著述	沉著述
泳气钟	泳氣鐘
垂发	垂髮
嘴裡	嘴裏
隔著	隔着
五天后	五天後
霁范	霽範
配著稱	配著稱
佛钟	佛鐘
干渴	乾渴
嬷	嬤
唱著者	唱著者
大历	大曆
夏天裡	夏天裏
炼制	煉製
展著名	展著名
盈余	盈餘
獲著錄	獲著錄
于戏	於戲
8余	8餘
税	稅
跑著述	跑著述
专向往	專向往
當著錄	當著錄
稳	穩
独占鳌头	獨佔鰲頭
丑男	醜男
急著述	急著述
皮制	皮製
耀著名	耀著名
稣	穌
掙著作	掙著作
繞著作	繞著作
反覆	反覆
叠	疊
系累	繫纍
号	號
叶	葉
涳蒙	涳濛
叹	嘆
绾发	綰髮
不占吉凶	不占吉凶
空著錄	空著錄
吉里巴斯	基里巴斯
揉著書	揉著書
参	參
叁	叄
干撂台	乾撂台
面包围	面包圍
赞誉	讚譽
放松	放鬆
郁沉沉	鬱沉沉
复习	複習
双	雙
发	發
叙	敘
变	變
背著述	背著述
呆里呆气	呆裡呆氣
丑女效颦	醜女效顰
肚里	肚裡
淀淀	澱澱
严云农	嚴云農
䯃	𩣑
回纹针	迴紋針
䯄	騧
䯅	䯀
保障著稱	保障著稱
在于	在於
兆余	兆餘
特制	特製
珰	璫
珲	琿
抓药	抓藥
天后天	天後天
附著述	附著述
制做	製做
〇余	〇餘
苦著作	苦著作
痕迹	痕迹
珑	瓏
珐	琺
郁抑	鬱抑
伊尔汗历表	伊爾汗曆表
万象	萬象
仑	侖
滚	滾
全干	全乾
找得著	找得着
做著述	做著述
削发	削髮
占南	佔南
暗著名	暗著名
余弦	餘弦
斗技	鬥技
7周后	7周後
复利	複利
于晴	于晴
复制	複製
三年	三年
行著作	行著作
莜面	莜麵
厘订	釐訂
会干	會幹
咸海	鹹海
心里	心裡
栖	棲
净余	淨餘
万年历	萬年曆
五出版	五出版
元凶	元兇
特制定	特制定
丑年	丑年
于焉	於焉
赵治勋	趙治勳
蟻后	蟻后
做著錄	做著錄
涵著錄	涵著錄
田庄英雄	田庄英雄
换	換
收获	收穫
于贝尔	于貝爾
并入	併入
钟不	鐘不
钟上	鐘上
站著書	站著書
喂鱼	餵魚
臨著名	臨著名
溢著錄	溢著錄
托言	託言
抓著者	抓著者
一余	一餘
日志	日誌
面包括	面包括
简并	簡併
仗著名	仗著名
盾著作	盾著作
汲于	汲於
吃里扒外	吃裡扒外
体系	體系
国历	國曆
佣仆	傭僕
〇只	〇隻
舍己为人	捨己為人
釀著書	釀著書
不著邊際	不着邊際
栏	欄
五出生	五出生
范例	範例
二出生	二出生
孤著名	孤著名
范登堡	范登堡
钟鸣	鐘鳴
呆性	獃性
自制	自製
遇著述	遇著述
冲击	衝擊
借著名	借著名
脏了	髒了
走著作	走著作
于志宁	于志寧
金钟	金鐘
蒙庄	蒙莊
挽联	輓聯
脊梁	脊樑
提著述	提著述
蛔虫药	蛔蟲藥
布雷速度	佈雷速度
鎭	鎮
窗明几净	窗明几淨
迷魂药	迷魂藥
𫁡	鴗
殺著述	殺著述
钟表快	鐘錶快
蘸著者	蘸著者
谷贵饿农	穀貴餓農
国仇	國讎
伊府面	伊府麵
郁郁而终	鬱鬱而終
对华发动	對華發動
满	滿
愛著述	愛著述
医院里	醫院裡
太仆	太僕
胡子	鬍子
挂彩	挂彩
七出刊	七出刊
冰淇淋	雪糕
厮斗	廝鬥
准绳	準繩
站著稱	站著稱
七个	七個
逆著述	逆著述
試著書	試著書
于會泳	于會泳
碍难照准	礙難照准
贤	賢
朱谕	硃諭
夾著書	夾著書
連著錄	連著錄
枕著作	枕著作
于伟国	于偉國
复电	複電
吊挂着	吊掛著
孤著	孤着
瞪著錄	瞪著錄
上签收	上簽收
算准	算準
孤著述	孤著述
橹	櫓
橼	櫞
干略	幹略
洒水	洒水
道范	道範
橥	櫫
于该	於該
荜	蓽
荞	蕎
荟	薈
心系非	心繫非
荚	莢
栗冽	慄冽
３只	３隻
逼并	逼併
松劲	鬆勁
伴著稱	伴著稱
松动	鬆動
争斗	爭鬥
荆	荊
复分数	複分數
囿于	囿於
巡回医疗	巡回醫療
據著稱	據著稱
挂名	掛名
荬	蕒
荭	葒
荮	葤
受著	受着
荨	蕁
荩	藎
盾著	盾着
余僇	餘僇
荤	葷
荥	滎
用著名	用著名
荧	熒
荠	薺
荡	盪
荣	榮
天文钟	天文鐘
于湘蘭	于湘蘭
站著	站着
斥著	斥着
棱柱	稜柱
于斯納爾斯貝里	于斯納爾斯貝里
纸扎	紙紮
咤	吒
著火	着火
候著	候着
簸荡	簸蕩
尋著者	尋著者
鱼松	魚鬆
當著述	當著述
想著者	想著者
獲著述	獲著述
旷	曠
后母戊	后母戊
心系贫	心繫貧
福斯	福士
咝	噝
吹著書	吹著書
猜著錄	猜著錄
涼著名	涼著名
跪著名	跪著名
咛	嚀
朱色	硃色
私下里	私下裡
舍去	捨去
征状	徵狀
備著作	備著作
燒著作	燒著作
刺绣	刺繡
铜钟	銅鐘
分多钟	分多鐘
余杭	餘杭
䌶	䊷
余杯	餘杯
表速	錶速
䌹	絅
䌸	縳
出于	出於
䌾	䋻
䌽	綵
䌼	綐
炼字	鍊字
吊场	弔場
折梯	摺梯
心系曼	心繫曼
椰枣干	椰棗乾
占次	佔次
锤炼	錘鍊
钟表历史	鐘錶歷史
多只是	多只是
晃著述	晃著述
欲念	慾念
隐占	隱佔
人物志	人物誌
香山庄	香山庄
药方	藥方
媪	媼
冒著	冒着
呆话	獃話
学	學
里海	裏海
呂后	呂后
向著書	向著書
于天仁	于天仁
绣口	繡口
倾复	傾複
端庄	端莊
准不准许	准不准許
窜	竄
酒坛	酒罈
毁钟为铎	毀鐘為鐸
飄著稱	飄著稱
䑽	𦪙
黏著	黏着
余量	餘量
窎	窵
窍	竅
綁著錄	綁著錄
獲著書	獲著書
窃	竊
风干	風乾
骢	驄
表面	表面
考著作	考著作
左冲右突	左衝右突
另辟	另闢
窦	竇
窥	窺
雇员	僱員
渴著者	渴著者
他钟	他鐘
多天后	多天後
彭于晏	彭于晏
时钟	時鐘
摟著錄	摟著錄
８余	８餘
旁征博引	旁徵博引
不干擾	不干擾
望著名	望著名
征庸	徵庸
圍著錄	圍著錄
潤著稱	潤著稱
占葡	佔葡
領著者	領著者
考著錄	考著錄
于都縣	于都縣
有征	有徵
余９	餘９
石家庄	石家莊
干细胞	幹細胞
高著名	高著名
文思泉涌	文思泉湧
干衣	乾衣
刻著者	刻著者
抗御	抗禦
挤	擠
划过来	划過來
9年	9年
占九	佔九
骒	騍
划走	划走
骓	騅
忍著稱	忍著稱
斗劲	鬥勁
划起	划起
那么着	那麼著
于慧	于慧
于幼軍	于幼軍
乡愿	鄉愿
據著名	據著名
四天后	四天後
干鱼	乾魚
冀著者	冀著者
于陆	於陸
赞乐	讚樂
斗力	鬥力
汇丰	滙豐
吊脚儿事	弔腳兒事
轉著者	轉著者
霉黑	黴黑
8天后	8天後
面包抄	面包抄
急于	急於
要占卜	要占卜
霉黧	黴黧
帕劳	帛琉
揪须	揪鬚
澄澹精致	澄澹精致
平准	平準
如果干	如果幹
才此	纔此
變著者	變著者
麗著書	麗著書
垦辟	墾闢
参绥	蔘綏
毛里求斯	毛里裘斯
钟行	鐘行
面团	麵糰
重锤	重鎚
拉杆	拉杆
姜丝	薑絲
豆干	豆乾
上药	上藥
戴著名	戴著名
䴖	鶄
长于	長於
萦回	縈迴
变髒	變髒
发漂	髮漂
喂羊	餵羊
余８	餘８
面摊	麵攤
余３	餘３
余２	餘２
余１	餘１
余０	餘０
余７	餘７
余６	餘６
余５	餘５
余４	餘４
抢	搶
抡	掄
抠	摳
0天后	0天後
头巾吊在水里	頭巾弔在水裡
报	報
护	護
急冲而下	急衝而下
造曲	造麯
余生	餘生
自制之能	自制之能
骨坛	骨罈
干啼	乾啼
渊淳岳峙	淵淳嶽峙
口干涉	口干涉
表板	錶板
并发模式	併發模式
其八九只	其八九只
抛	拋
顼	頊
顿	頓
于若木	于若木
抟	摶
顸	頇
须	須
顺	順
看著述	看著述
顷	頃
顶	頂
拉面无	拉面無
干啥	幹啥
忙著書	忙著書
𩨍	𩥇
偷著書	偷著書
耕获	耕穫
采访	採訪
2年	2年
持著	持着
卷菸	捲菸
著數	着數
于凤桐	于鳳桐
才干	才幹
葡萄干	葡萄乾
市占	市佔
擀面	擀麵
借助	藉助
吊古寻幽	弔古尋幽
甜著者	甜著者
心著者	心著者
覆盖着	覆蓋著
乐器钟	樂器鐘
找不著	找不着
武后	武后
咸的	鹹的
系里	系裡
优游	優遊
韫	韞
吊拷绷扒	弔拷繃扒
味著名	味著名
十出逃	十出逃
韪	韙
沣	灃
顽	頑
没	沒
沧	滄
沦	淪
跳著述	跳著述
蒙著述	蒙著述
沪	滬
沩	溈
游兴	遊興
冲克	衝剋
你克制	你剋制
顾	顧
雪鐵龍	先進
项	項
示范	示範
鋪著書	鋪著書
刻著錄	刻著錄
袅	裊
袄	襖
岳麓	嶽麓
袆	褘
采薇	採薇
朴素	樸素
页	頁
流著作	流著作
袭	襲
后土	后土
袯	襏
采薪	採薪
杨	楊
于半	於半
不只	不只
于十	於十
谷保家商	穀保家商
归余	歸餘
隔著作	隔著作
亚于	亞於
巧妇做不得无面馎饦	巧婦做不得無麵餺飥
准保護	准保護
心系地	心繫地
卤	鹵
来	來
卢	盧
卫	衛
却	卻
酿制	釀製
低著書	低著書
波士尼亞赫塞哥維納	波斯尼亞黑塞哥維那
嚷著者	嚷著者
大丑	大丑
丰韵	丰韻
戴著書	戴著書
卺	巹
咸淡	鹹淡
穿著者	穿著者
占人便宜	佔人便宜
髭著作	髭著作
云何	云何
合著者	合著者
单	單
卖	賣
拉面	拉麵
几面上	几面上
钟表面	鐘表面
牵	牽
鋪著名	鋪著名
戴著稱	戴著稱
晃著者	晃著者
䩄	靦
牺	犧
牦	氂
飄著書	飄著書
炼冶	鍊冶
体范	體範
潜水表	潛水錶
斗批改	鬥批改
这么	這麼
洪钟	洪鐘
喂了	餵了
幸幸	倖幸
牍	牘
淀北片	澱北片
皇历	皇曆
手塚治虫	手塚治虫
五扎	五紮
花拳绣腿	花拳繡腿
吴	吳
接著作	接著作
启	啟
听	聽
吨	噸
吣	唚
模范棒棒堂	模范棒棒堂
吗	嗎
吕	呂
吓	嚇
考试	考試
后	後
語著	語着
翕辟	翕闢
凶悍	兇悍
凶恶	兇惡
跳著書	跳著書
千年	千年
拉面上	拉面上
钟螺	鐘螺
松紧	鬆緊
出丑	出醜
籁	籟
辫发	辮髮
于赠	于贈
家仆	家僕
抓著	抓着
騙著者	騙著者
駕著	駕着
干田	乾田
順著作	順著作
潤著述	潤著述
天历	天曆
抽公签	抽公籤
側著者	側著者
发鬓	髮鬢
类	類
在著者	在著者
心系晓	心繫曉
潜水钟	潛水鐘
准三后	准三后
信著述	信著述
躍著錄	躍著錄
候复	候覆
采录	採錄
药王	藥王
开采	開採
力克制	力剋制
涩谷区	澀谷區
捣鬼吊白	搗鬼弔白
呗	唄
冲程	衝程
占在	佔在
關著錄	關著錄
征令	徵令
志著述	志著述
干支剌	乾支剌
望着表	望著錶
复核	複核
扛著述	扛著述
划槳	划槳
怠于	怠於
心著述	心著述
努力著書	努力著書
浮夸	浮誇
瓮安	甕安
求著者	求著者
胡渣	鬍渣
国历代	國歷代
扛大梁	扛大樑
停征	停徵
心系父	心繫父
液晶表	液晶錶
溢著書	溢著書
0多只	0多隻
于思	于思
占场	佔場
府干犯	府干犯
于怀	於懷
盛著錄	盛著錄
駕著書	駕著書
于娟	于娟
于娜	于娜
閑著作	閑著作
側著	側着
干裂	乾裂
灰蒙	灰濛
文汇报	文匯報
个中玄机	箇中玄機
征引	徵引
因著書	因著書
悯	憫
只冲	只衝
不占卜	不占卜
占俄	佔俄
逞凶斗狠	逞兇鬥狠
咸菜	鹹菜
征调	徵調
松快	鬆快
游必有方	遊必有方
夾著稱	夾著稱
补药	補藥
能干预	能干預
背著者	背著者
爭著	爭着
毕	畢
折痕	摺痕
划去	划去
毙	斃
錾	鏨
复色	複色
變著錄	變著錄
毁	毀
毂	轂
宝庄	寶莊
辛丑	辛丑
迹	跡
毵	毿
复眼	複眼
海珊	侯賽因
沟	溝
寒于	寒於
洒涤	洒滌
们克制	們剋制
毡	氈
图里	圖裡
镰仓	鎌倉
豎著者	豎著者
遇著者	遇著者
吊撒	弔撒
開著稱	開著稱
于天龙	于天龍
制著作	制著作
余兴	餘興
余八	餘八
叱咤	叱咤
余六	餘六
備著稱	備著稱
于广洲	于廣洲
蝎谮	蝎譖
菸	煙
余党	餘黨
钟没	鐘沒
沥	瀝
子晳	子晳
沤	漚
旅游	旅遊
吊问	弔問
余光	餘光
几只	幾隻
隨著書	隨著書
范性形变	範性形變
范文藤	范文藤
蘸著述	蘸著述
森林里	森林裡
戯	戱
冲垮	衝垮
土豆網	土豆網
痒疹	痒疹
干哭	乾哭
追著述	追著述
后面店	後面店
列支敦斯登	列支敦士登
馬利共和國	馬里共和國
复议	複議
红霉素	紅霉素
干篾片	乾篾片
四面包	四面包
戏	戲
戋	戔
应钟	應鐘
戆	戇
五个	五個
看准	看準
館裡	館裏
干柴烈火	乾柴烈火
干哕	乾噦
著妳	着妳
麗著稱	麗著稱
𨱏	鎝
𨱎	鍮
𨱍	鎯
𨱌	鏆
𨱋	錂
𨱊	𨧱
唱著書	唱著書
𨱈	鋉
𨱇	銶
𨱅	鉁
𨱄	鈯
𨱃	鈲
𨱂	鈋
𨱁	鈠
分占	分佔
扛著名	扛著名
网里	網裡
𨱕	𨮂
𨱔	鐏
𨱓	鐎
𨱒	鏉
雜著	雜着
𨱐	𨫒
准例	準例
住著述	住著述
注译	註譯
制取	製取
人参加	人參加
衬里	襯裡
流荡	流蕩
梁柱	樑柱
志著	志着
里边	裡邊
发廊	髮廊
密致	密緻
八年	八年
娆	嬈
娇	嬌
路签	路籤
娅	婭
仗著述	仗著述
冲陷	衝陷
草丛里	草叢裡
代码表	代碼表
娴	嫻
娲	媧
娱	娛
辟为	闢為
无征不信	無徵不信
蛴	蠐
村庄	村莊
涼著	涼着
奸情	姦情
鼠曲草	鼠麴草
于１	於１
𪨗	屩
于３	於３
于２	於２
于５	於５
于４	於４
于７	於７
于６	於６
于９	於９
于８	於８
康著作	康著作
淳朴	淳樸
占用	佔用
钟表王	鐘錶王
电	電
庄户	莊戶
蛎	蠣
画	畫
𪨊	㞞
题签	題籤
庄房	莊房
九出生	九出生
不嫌母丑	不嫌母醜
袜	襪
䓕	薳
亿个	億個
落发	落髮
不准确	不準確
冲要	衝要
持著述	持著述
很丑	很醜
还占	還佔
伙头	伙頭
不干休	不干休
愛著作	愛著作
刮起来	刮起來
咸湖	鹹湖
關著作	關著作
舍短取长	捨短取長
复位	複位
移动电话	流動電話
勋	勛
门吊儿	門弔兒
盯著稱	盯著稱
撞阵冲军	撞陣衝軍
獨著錄	獨著錄
钟表行	鐘錶行
墙里	牆裡
旋绕着	旋繞著
勚	勩
口干预	口干預
雜著作	雜著作
干糇	乾餱
5只支援	5只支援
狱	獄
狰	猙
狲	猻
风土志	風土誌
狭	狹
独	獨
狯	獪
狮	獅
婵	嬋
丑沮	醜沮
钟顶	鐘頂
周杰倫	周杰倫
堕	墮
狝	獮
大历史	大歷史
狞	獰
暗著作	暗著作
松通	鬆通
金表面	金表面
刮了	颳了
狈	狽
垂于	垂於
堑	塹
喜欢钟	喜歡鐘
干系	干係
戴发含齿	戴髮含齒
闻风后	聞風後
壮游	壯遊
斗斗	鬥鬥
干耗	乾耗
赤绳系足	赤繩繫足
斗文	鬥文
冒著名	冒著名
頂著書	頂著書
解铃还须系铃人	解鈴還須繫鈴人
駕著述	駕著述
绞干	絞乾
占尽	佔盡
钟发音	鐘發音
僵尸	殭屍
心系病	心繫病
不准她	不准她
斗引	鬥引
不干它	不干它
借著作	借著作
掖著錄	掖著錄
干酪	乾酪
占少	佔少
沙里淘金	沙裡淘金
側著錄	側著錄
层	層
住扎	住紮
占小	佔小
药引	藥引
划进来	划進來
第四出局	第四出局
里脊	裡脊
於夫罗	於夫羅
拖著作	拖著作
几旁	几旁
暴敛横征	暴斂橫徵
大型钟	大型鐘
暗地里	暗地裡
宦游	宦遊
耀著者	耀著者
抬著名	抬著名
冲突	衝突
低著者	低著者
牵系	牽繫
鬥著作	鬥著作
陋著者	陋著者
合府	閤府
巡游	巡遊
不干我	不干我
蹪于	蹪於
制为	製為
口干	口乾
只字	隻字
姜糖	薑糖
刻钟	刻鐘
鸡争鹅斗	雞爭鵝鬥
對著者	對著者
构	構
战栗	戰慄
喝著名	喝著名
钉锤	釘鎚
昆腔	崑腔
鲸须	鯨鬚
于欣源	于欣源
湖里	湖裡
真凶	真兇
被发阳狂	被髮陽狂
繞著書	繞著書
呆等	獃等
月历	月曆
努力著者	努力著者
于邑	於邑
日子里	日子裡
丰韻	丰韻
为着	為著
霉素	黴素
氇	氌
那只有	那只有
邬	鄔
获	獲
邮	郵
跳表	跳錶
监制	監製
中文裡	中文裏
心系在	心繫在
邺	鄴
邻	鄰
恶斗	惡鬥
子之丰兮	子之丰兮
成药	成藥
領著稱	領著稱
猜著者	猜著者
只身旁	只身旁
氢	氫
金仆姑	金僕姑
刻著稱	刻著稱
氩	氬
游民	遊民
邝	鄺
氲	氳
七只	七隻
邓	鄧
白发	白髮
眍	瞘
余荫	餘蔭
吊膀子	弔膀子
黑奴吁天录	黑奴籲天錄
騎著書	騎著書
褛	褸
見著	見着
拿著者	拿著者
靠著者	靠著者
干礼	乾禮
闹表	鬧錶
霉菌	黴菌
干生受	乾生受
迁于	遷於
代表著稱	代表著稱
采用	採用
吊扣	弔扣
不占	不佔
火箭布雷	火箭佈雷
埃及历	埃及曆
苦著者	苦著者
湮郁	湮鬱
墨沈	墨沈
细不容发	細不容髮
华	華
洒洒	洒洒
著地	着地
八扎	八紮
腰里	腰裡
青霉素	青霉素
當著	當着
歼	殲
麦	麥
所托	所託
发笺	髮箋
于家堡	于家堡
于道泉	于道泉
中文里	中文裡
哭著作	哭著作
麸	麩
逼著稱	逼著稱
于途	於途
聩	聵
聪	聰
枯干	枯乾
余6	餘6
美于	美於
准决赛	準決賽
見著述	見著述
因著稱	因著稱
據著述	據著述
醜著名	醜著名
佣兵	傭兵
叱吒	叱咤
聋	聾
职	職
聍	聹
所占星	所占星
聂	聶
仆程	僕程
睡著書	睡著書
6只支持	6只支持
釀著者	釀著者
挑著作	挑著作
釀著	釀着
联	聯
淀谓之滓	澱謂之滓
万周后	萬周後
汇编	彙編
昙	曇
飄著	飄着
拓朴	拓樸
批斗	批鬥
照入签	照入籤
蕴	蘊
挑著錄	挑著錄
鼓里	鼓裡
面包庇	面包庇
喜向往	喜向往
響著	響着
占嗫	佔囁
回肠	迴腸
万只	萬隻
于是乎	於是乎
轮回	輪迴
冲车	衝車
糁	糝
几净窗明	几淨窗明
空著作	空著作
糇	餱
印著書	印著書
饥馑	饑饉
斗眼	鬥眼
凶相毕露	凶相畢露
心系彼	心繫彼
模范	模範
風采	風采
干疥	乾疥
人云	人云
布雷封锁	佈雷封鎖
趴著書	趴著書
蒜发	蒜髮
披著	披着
坏于	坏於
妈	媽
斗头	鬥頭
回诵	迴誦
系着	系著
妆	妝
響著者	響著者
绣像	繡像
里手	裏手
发干	發乾
皮松	皮鬆
傲游	傲遊
太初历史	太初歷史
吊民伐罪	弔民伐罪
妩	嫵
妪	嫗
妫	媯
颠颠仆仆	顛顛仆仆
婢仆	婢僕
心裡	心裏
冲量	衝量
差之毫厘	差之毫厘
吊影	弔影
疮	瘡
疯	瘋
疬	癧
疭	瘲
疠	癘
疡	瘍
鬥著錄	鬥著錄
采择	採擇
心系港	心繫港
全面包裹	全面包裹
疱	皰
時間裡	時間裏
爭著作	爭著作
重复	重複
向著稱	向著稱
产卵洄游	產卵洄游
纪历史	紀歷史
荡妇	蕩婦
银发	銀髮
猜著	猜着
試著述	試著述
凤凰于飞	鳳凰于飛
疖	癤
疗	療
斗牙拌齿	鬥牙拌齒
照占	照佔
于它	於它
脱发	脫髮
丝虫	絲蟲
衅钟	釁鐘
金表扬	金表揚
采在	採在
于凌奎	于凌奎
由表及里	由表及裡
征得	徵得
燒著	燒着
农民历史	農民歷史
鸡吵鹅斗	雞吵鵝鬥
泾	涇
渴著作	渴著作
回旋加速	回旋加速
于家	於家
余论	餘論
埔裡社撫墾局	埔裏社撫墾局
并日而食	并日而食
强于	強於
腾格里	騰格里
锡	錫
醜著稱	醜著稱
占住	佔住
占位	佔位
急著書	急著書
牙签	牙籤
盗钟	盜鐘
捏面人	捏麵人
大型钟表	大型鐘錶
隨著稱	隨著稱
趴著名	趴著名
零个	零個
㧟	擓
㧑	撝
电冲	電衝
瘆	瘮
多于	多於
拿著名	拿著名
挨著錄	挨著錄
靠著名	靠著名
村里长	村里長
夾著作	夾著作
塞耳盗钟	塞耳盜鐘
干股	乾股
阃范	閫範
面包涵	面包涵
干肥	乾肥
八出生	八出生
冀著	冀着
尽早	儘早
于小惠	于小惠
里衣	裡衣
借手	藉手
𩠆	𩜦
吊丧问疾	弔喪問疾
罵著述	罵著述
于洪區	于洪區
余墨	餘墨
紮著名	紮著名
乙丑	乙丑
炼汞	鍊汞
只身份	只身份
走著者	走著者
棱台	稜台
标杆	標杆
于爾里克	于爾里克
没样范	沒樣範
于敏中	于敏中
晃著名	晃著名
结发	結髮
余辉	餘輝
钟形虫	鐘形蟲
領著述	領著述
朴陋	樸陋
光著述	光著述
准时	準時
嚣	囂
世纪钟	世紀鐘
药店	藥店
掷	擲
掴	摑
掳	擄
演著述	演著述
掼	摜
私斗	私鬥
掺	摻
掸	撣
壳里	殼裡
藝著述	藝著述
精制服	精制服
三出口	三出口
饹	餎
饸	餄
饻	餏
饺	餃
饽	餑
饼	餅
饿	餓
饾	餖
饱	飽
饰	飾
饳	飿
饲	飼
饵	餌
于美	於美
饷	餉
寫著	寫着
松浮	鬆浮
饨	飩
饫	飫
衣著稱	衣著稱
饭	飯
饬	飭
饯	餞
饮	飲
干呕	乾嘔
饣	飠
饥	飢
一目了然	一目了然
饧	餳
饦	飥
䲠	鰆
绣花	繡花
蹑	躡
蹒	蹣
涂序瑄	涂序瑄
柳诒征	柳詒徵
吊者大悦	弔者大悅
折合	摺合
生殖洄游	生殖洄游
沿著書	沿著書
深淵裡	深淵裏
准会	準會
蹰	躕
勋章	勳章
桩	樁
晋升	晉陞
采区	採區
功致	功緻
藝著錄	藝著錄
蹿	躥
台州	台州
军队克制	軍隊剋制
逻	邏
站著作	站著作
党項	党項
后里	后里
涟	漣
桢	楨
涝	澇
麗著者	麗著者
飞行钟	飛行鐘
拖著錄	拖著錄
打拼	打拚
游河	遊河
递	遞
桡	橈
屏风后	屏風後
涩	澀
涨	漲
涧	澗
桦	樺
丑角	丑角
涤	滌
涣	渙
𨰾	鎷
涡	渦
涠	潿
适	適
乱发	亂髮
桤	榿
逊	遜
桥	橋
忙著名	忙著名
饤	飣
不采聲	不采聲
松一口气	鬆一口氣
存于	存於
心著錄	心著錄
開著書	開著書
占上风	佔上風
蝎蝎螫螫	蝎蝎螫螫
诗赞	詩讚
膠著述	膠著述
學著作	學著作
拖著述	拖著述
余蓄	餘蓄
出游	出遊
吊拷	弔拷
十出生	十出生
剩余	剩餘
佣中佼佼	傭中佼佼
福著作	福著作
没干没净	沒乾沒淨
載著名	載著名
屁股大吊了心	屁股大弔了心
干柴	乾柴
湿	濕
康著	康着
剥	剝
于克-蘭多縣	于克-蘭多縣
剧	劇
漫著書	漫著書
局里	局裡
剑	劍
剐	剮
荦确	犖确
于七	於七
于一	於一
而克制	而剋制
剀	剴
急著名	急著名
剂	劑
四年	四年
點裡	點裏
复信	複信
于丑	於醜
云乎	云乎
航天飞机	穿梭機
南游	南遊
轉著作	轉著作
借机	藉機
同于	同於
台面前	台面前
待著名	待著名
国历史	國歷史
力求克制	力求剋制
悠悠荡荡	悠悠蕩蕩
周六	周六
䥺	釾
中岳	中嶽
铅	鉛
䥿	𨯅
钟左右	鐘左右
采石之战	采石之戰
吞并	吞併
男佣人	男佣人
心于	心於
于風政	于風政
達著錄	達著錄
追著稱	追著稱
煎药	煎藥
于国治	于國治
心系嘱	心繫囑
瘗	瘞
胡云	胡云
于台煙	于台煙
四出征收	四出徵收
碑志	碑誌
夾著錄	夾著錄
留著者	留著者
一半只	一半只
后髮座	后髮座
丑婆子	丑婆子
保障著述	保障著述
扎带子	紮帶子
阿呆	阿獃
这只在	這只在
9天后	9天後
不准许	不准許
只言片语	隻言片語
悍药	悍藥
燕燕于飞	燕燕于飛
漫著述	漫著述
奸猾	姦猾
网	網
罗	羅
果干	果乾
折椅	摺椅
罂	罌
沿著	沿着
家俱	傢俱
迦納	加納
皇庄	皇莊
缓冲	緩衝
工致	工緻
罴	羆
看著者	看著者
冲过	衝過
戀著述	戀著述
罢	罷
澒蒙	澒濛
于农	於農
筑前	筑前
叫著錄	叫著錄
坐著名	坐著名
代表著	代表着
勤仆	勤僕
郁结	鬱結
几周后	幾周後
鳞	鱗
木钟	木鐘
釀著名	釀著名
鳜	鱖
准儿	準兒
台风	颱風
鳓	鰳
籼	秈
和奸	和姦
覆巢之下无完卵	覆巢之下無完卵
身著名	身著名
复次	複次
血余	血餘
烘制	烘製
千周后	千周後
花庵词选	花菴詞選
菜肴	菜肴
鳕	鱈
上面糊	上面糊
反朴	反樸
钵	缽
照著書	照著書
豎著作	豎著作
打风后	打風後
钟太	鐘太
朴鄙	樸鄙
昆剧	崑劇
甩发	甩髮
高著書	高著書
〇周后	〇周後
王田里	王田里
票庄	票莊
钩心斗角	鈎心鬥角
绷开	繃開
鳏	鰥
拿下表	拿下錶
麻酱面	麻醬麵
皺著名	皺著名
鳎	鰨
１年	１年
月丽于箕	月麗於箕
游走	遊走
坦荡	坦蕩
悒郁	悒鬱
鳃	鰓
丰台	丰台
尋著書	尋著書
連著述	連著述
含齿戴发	含齒戴髮
鳀	鯷
得著者	得著者
騙著書	騙著書
谨于心	謹於心
鳆	鰒
游资	遊資
肉丝面	肉絲麵
當著名	當著名
百年	百年
余割	餘割
偷著述	偷著述
待著述	待著述
征购	徵購
踏著作	踏著作
人参谋	人參謀
于根伟	于根偉
向著述	向著述
精辟	精闢
饭后钟	飯後鐘
梦里	夢裡
药商	藥商
斗倒	鬥倒
划进	划進
７周后	７周後
〇年	〇年
钟关	鐘關
郁黑	鬱黑
详注	詳註
兆个	兆個
悠著述	悠著述
划过	划過
空投布雷	空投佈雷
升官发财	升官發財
谷皮	穀皮
棱镜	稜鏡
驶	駛
鸟	鳥
麗著作	麗著作
空荡荡	空蕩蕩
二缶钟惑	二缶鐘惑
浮著	浮着
鸪	鴣
鸫	鶇
鸨	鴇
鸩	鴆
鸮	鴞
鸯	鴦
云：	云：
鸭	鴨
鸢	鳶
鸣	鳴
嚷著作	嚷著作
鸡	雞
鸦	鴉
鸧	鶬
鸤	鳲
鸥	鷗
鸺	鵂
鸻	鴴
鸸	鴯
鸹	鴰
鸾	鸞
十余	十餘
鸼	鵃
驼	駝
鸲	鴝
鸳	鴛
鸰	鴒
鸱	鴟
鸶	鷥
鸷	鷙
鸴	鷽
鸵	鴕
因著錄	因著錄
驾	駕
胶	膠
皺著錄	皺著錄
竹林之游	竹林之遊
貝南	貝寧
争红斗紫	爭紅鬥紫
點著錄	點著錄
大批涌到	大批湧到
朝著	朝着
胧	朧
胪	臚
敏于	敏於
胨	腖
驺	騶
吊文	弔文
美丑	美醜
清心寡欲	清心寡欲
壓著書	壓著書
胶卷	膠捲
盛著書	盛著書
胜	勝
胀	脹
胁	脅
胆	膽
邋里邋遢	邋裡邋遢
表快	錶快
干号	乾號
雠	讎
干台	乾颱
冒著述	冒著述
雳	靂
松蛋	鬆蛋
挡	擋
挠	撓
挣	掙
挢	撟
挥	揮
驯	馴
挦	撏
挛	攣
挚	摯
挝	撾
挜	掗
挟	挾
挞	撻
胡朴安	胡樸安
唱著	唱着
尼日	尼日爾
雏	雛
遇著錄	遇著錄
碛	磧
编钟	編鐘
合伙	合夥
余气	餘氣
挂	掛
帶著作	帶著作
心系澳	心繫澳
麗著名	麗著名
四面钟	四面鐘
于偉國	于偉國
试制	試製
朴直	樸直
鋪著	鋪着
塞药	塞藥
涼著錄	涼著錄
卷起	捲起
刚雇	剛僱
想著書	想著書
笑著者	笑著者
交游	交遊
夾著名	夾著名
中风后	中風後
義大利	意大利
卤水	滷水
干急	乾急
行動電話	流動電話
忙著述	忙著述
千回百折	千迴百折
余思敏	余思敏
聞著	闻着
披著者	披著者
望著	望着
刘克庄	劉克莊
头	頭
相克	相剋
夺	奪
波发藻	波髮藻
夸	誇
夹	夾
钤	鈐
备	備
处	處
滃郁	滃鬱
个钟表	個鐘錶
复	復
脊梁骨	脊梁骨
口试	口試
擺著述	擺著述
卧游	臥遊
够	夠
出电视	齣電視
４年	４年
八字胡	八字鬍
绷紧	繃緊
吹著稱	吹著稱
琼	瓊
手表明	手表明
卤肉	滷肉
禾谷	禾穀
拧	擰
琏	璉
前往	前往
苦干	苦幹
干打雷	乾打雷
喂了一声	喂了一聲
琐	瑣
击	擊
曲尘	麴塵
零只	零隻
7天后	7天後
凿	鑿
０年	０年
丑毙了	醜斃了
创获	創穫
奸淫	姦淫
咸潟	鹹潟
凫	鳧
于人	於人
干杯	乾杯
凭	憑
从于	從於
警世钟	警世鐘
几	幾
汉弥登钟	漢彌登鐘
凤	鳳
凛	凜
后冠	后冠
于事	於事
于二	於二
马自达	萬事得
止痛药	止痛藥
凑	湊
干材	乾材
哭著書	哭著書
在著	在着
凉	涼
踯	躑
减	減
百余	百餘
净	凈
摟著	摟着
纡余	紆餘
斲雕为朴	斲雕為樸
流著錄	流著錄
于尔根	于爾根
馂余	餕餘
躺著	躺着
殺著名	殺著名
𪉑	鷔
𪉐	𪃍
𪉒	𪄕
𪉕	𪇳
𪉔	𪄆
波棱菜	波稜菜
械系	械繫
缠斗	纏鬥
𪉃	鳼
𪉂	䲰
𪉅	𪀦
𪉄	𩿪
弥漫着	瀰漫著
𪉆	鴲
皺著稱	皺著稱
𪉈	鴜
𪉋	𪀾
𪉊	鷨
𪉍	鵚
𪉌	𪁖
𪉏	𪃏
𪉎	𪂆
卷款	捲款
多丑	多醜
攻占	攻佔
紮著	紮着
托人	託人
多只可	多只可
担	擔
复名	複名
复合	複合
逼著名	逼著名
菠萝干	菠蘿乾
含著	含着
舒卷	舒捲
药草	藥草
百周后	百周後
百只足夠	百只足夠
于遠偉	于遠偉
汤药	湯藥
游荡	遊盪
筑州	筑州
唾面自干	唾面自乾
托了	託了
托事	託事
干劲	幹勁
干脆	乾脆
咸菜干	鹹菜乾
沈山线	瀋山線
任何表	任何錶
修杰楷	修杰楷
脏发	髒髮
仆夫	僕夫
发为血之本	髮為血之本
涂壮勋	涂壯勳
覆雨翻云	覆雨翻雲
望了望	望了望
干肉片	乾肉片
燒著書	燒著書
荡气回肠	蕩氣迴腸
累囚	纍囚
药师	藥師
辟谷	辟穀
余光中	余光中
进占	進佔
捆著名	捆著名
撼著者	撼著者
裝著錄	裝著錄
法自制	法自制
游记	遊記
女佣	女傭
忠于	忠於
个中消息	箇中消息
爱	愛
水里	水裡
6周后	6周後
披榛采兰	披榛採蘭
症候群	症候群
喂鹅	餵鵝
特别致	特别致
鞲	韝
獲著	獲着
面茶	麵茶
药用	藥用
當著稱	當著稱
于再清	于再清
以自制	以自制
提著名	提著名
力争上游	力爭上遊
征怪	徵怪
钓	釣
言大而夸	言大而夸
干办	幹辦
𩧦	𩡺
并为一家	併為一家
留著錄	留著錄
逆著名	逆著名
你斗了胆	你斗了膽
女佣人	女佣人
镉	鎘
洒	灑
于尔岑	于爾岑
黏著作	黏著作
镋	鎲
没梢干	沒梢幹
嘉谷	嘉穀
殺著書	殺著書
外强中干	外強中乾
拼著	拼着
十出	十齣
醯	酰
冬日裡	冬日裏
带发修行	帶髮修行
行凶後	行兇後
长历史	長歷史
困著稱	困著稱
谷谷	穀穀
洼	窪
映著名	映著名
利于	利於
喝著述	喝著述
安沈铁路	安瀋鐵路
殺著稱	殺著稱
丑行	醜行
镄	鐨
汉弥登钟表公司	漢彌登鐘錶公司
大型钟表面	大型鐘表面
复选	複選
宽松	寬鬆
沈着	沈著
河流汇集	河流匯集
9余	9餘
𩾋	䱰
𩾊	䱬
𩾈	䱙
偷著	偷着
官历	官曆
𩾌	鱇
來著述	來著述
待著者	待著者
𩾀	鮕
𩾇	鯱
𩾆	𩸦
逼著述	逼著述
𩾄	𩷰
龌	齷
龈	齦
龉	齬
龊	齪
龋	齲
龄	齡
龅	齙
龆	齠
龇	齜
龀	齔
龁	齕
龂	齗
龃	齟
镑	鎊
龟	龜
龙	龍
龚	龔
帶著	帶着
著鞭	着鞭
沈淀	沈澱
摈	擯
算发	算髮
摆	擺
摇	搖
摄	攝
摅	攄
纏著名	纏著名
持著稱	持著稱
镩	鑹
重回	重回
逆著錄	逆著錄
腼	靦
腽	膃
腾	騰
于韦斯屈莱	于韋斯屈萊
腻	膩
铁锈	鐵鏽
采金	採金
露丑	露醜
與著述	與著述
腭	齶
心系长	心繫長
志喜	誌喜
墨沈未干	墨瀋未乾
扎实	紮實
陳冲	陳冲
𫍢	譊
人参考	人參考
凭借	憑藉
印累绶若	印纍綬若
镣	鐐
腊	臘
你才子发昏	你纔子發昏
托故	託故
腊笔	腊筆
心脏	心臟
岱岳	岱嶽
伙同	夥同
八个	八個
割舍	割捨
亿年	億年
典范	典範
０多只	０多隻
8周后	8周後
钟表	鐘錶
祝赞	祝讚
之征	之徵
易克制	易剋制
翘	翹
联系	聯繫
七出版	七出版
古朴	古樸
隨著作	隨著作
摟著名	摟著名
离于	離於
髭胡	髭鬍
吊头	弔頭
修杰麟	修杰麟
镲	鑔
镵	鑱
敞著	敞着
·范	·范
素面	素麵
豫著書	豫著書
钟停	鐘停
䥽	鏺
鋪著作	鋪著作
６余	６餘
孤著書	孤著書
里层	裡層
樂著稱	樂著稱
里屋	裡屋
轨范	軌範
蒙事	矇事
呆呆傻傻	呆呆傻傻
辦著書	辦著書
五岳	五嶽
２只	２隻
慌里慌张	慌裡慌張
征答	徵答
表的嘀嗒	錶的嘀嗒
耀著作	耀著作
不占算	不占算
施于	施於
校仇	校讎
墙	牆
綑扎	綑紮
去著稱	去著稱
斗成	鬥成
巴貝多	巴巴多斯
藏历史	藏歷史
𪢮	圞
占有	佔有
不好干涉	不好干涉
月离于毕	月離於畢
靠著作	靠著作
當著者	當著者
筑阳	筑陽
7只支援	7只支援
掖著名	掖著名
天后来	天後來
厘定	釐定
抢占	搶佔
穿著	穿着
偷鸡不着	偷雞不著
占率	佔率
捆著錄	捆著錄
年历史	年歷史
璎	瓔
劉佳怜	劉佳怜
喝著者	喝著者
于风政	于風政
月历史	月歷史
干屎橛	乾屎橛
山棱	山稜
余勇	餘勇
种师道	种師道
叩钟	叩鐘
麗著	麗着
才得两年	纔得兩年
府干擾	府干擾
中美发表	中美發表
空著名	空著名
𩙰	𩙈
容于	容於
余貾	餘貾
浓发	濃髮
刮起	颳起
刮走	颳走
答复	答覆
安地卡及巴布達	安提瓜和巴布達
𩙦	𩗀
𩙧	𩗡
𩙥	颰
𩙪	颷
𩙫	颾
𩙨	𩘹
丰南	丰南
𩙮	䬘
𩙯	䬝
𩙬	𩘺
𩙭	𩘝
柯林頓	克林頓
台风后	颱風後
千钧一发	千鈞一髮
面包管	面包管
丑媳	醜媳
植发	植髮
仆役	僕役
郑	鄭
應著述	應著述
老庄	老莊
药品	藥品
西占	西佔
复元音	複元音
好斗室	好斗室
㻘	𤪺
溟蒙	溟濛
拖著	拖着
㻏	𤫩
六出	六齣
脏的	髒的
白干	白乾
往里	往裡
里勾外连	裡勾外連
药糖	藥糖
丑态	醜態
，克制	，剋制
于台烟	于台煙
郁气	鬱氣
于毕	於畢
划水	划水
面馆	麵館
呆憨呆	獃憨獃
搭干铺	搭乾鋪
余妙	餘妙
开征	開徵
里面	裡面
制品	製品
服药	服藥
防水表	防水錶
心系着	心繫著
２年	２年
喂猪	餵豬
车站里	車站裡
宜云	宜云
足于	足於
勾魂荡魄	勾魂蕩魄
于振武	于振武
抓著述	抓著述
陧	隉
挽词	輓詞
官不怕大只怕管	官不怕大只怕管
闲情逸致	閒情逸緻
种放	种放
险	險
拎著者	拎著者
夢著者	夢著者
个旧	箇舊
醫院裡	醫院裏
黄干黑瘦	黃乾黑瘦
萨达姆	薩達姆
干卦	乾卦
行著錄	行著錄
丰滨	豐濱
青霉	青黴
干阿奶	乾阿奶
际	際
裁并	裁併
陆	陸
水来汤里去	水來湯裡去
药针	藥針
狂占	狂佔
占头	佔頭
搬斗	搬鬥
陉	陘
陈	陳
合采	合採
陕	陝
厂部	厂部
干酵母	乾酵母
冲下	衝下
冲上	衝上
骂着	罵著
陪著稱	陪著稱
里应外合	裡應外合
黄曲毒素	黃麴毒素
于0	於0
朝著作	朝著作
于2	於2
于3	於3
于4	於4
于5	於5
于6	於6
留著作	留著作
于8	於8
于9	於9
做著	做着
斗草	鬥草
转	轉
轭	軛
轮	輪
软	軟
轨	軌
轩	軒
轪	軑
轫	軔
拉面皮	拉面皮
獨著	獨着
轧	軋
后姓	后姓
轼	軾
大蜡	大蜡
轾	輊
轿	轎
轸	軫
轹	轢
轺	軺
轻	輕
轴	軸
轵	軹
轶	軼
轷	軤
轰	轟
轱	軲
轲	軻
轳	轤
荡漾	蕩漾
３余	３餘
仿制	仿製
丰情	丰情
鲚	鱭
酒帘	酒帘
浅	淺
溃	潰
鲜	鮮
双折	雙摺
府干政	府干政
溆	漵
溅	濺
6年	6年
在制品	在制品
鲞	鯗
考著者	考著者
于之	於之
竹签	竹籤
豎著名	豎著名
鲐	鮐
风起云涌	風起雲湧
意大利面	意大利麵
向往常	向往常
躺著作	躺著作
冒著者	冒著者
鬈发	鬈髮
准确	準確
拼绝	拚絕
干将	幹將
于潜县	於潛縣
采油	採油
萝卜干	蘿蔔乾
呆呆獸	呆呆獸
泛游	泛遊
紮著稱	紮著稱
鲈	鱸
蚁	蟻
蚀	蝕
禁欲	禁慾
蚂	螞
绑扎	綁紮
蚕	蠶
干尸	乾屍
裹著名	裹著名
于泽尔	于澤爾
裝著者	裝著者
占得	佔得
鞭辟入里	鞭辟入裡
花哄	花鬨
兹	茲
养	養
曼谷人	曼谷人
兴	興
千只能	千只能
兰	蘭
关	關
注明	註明
童仆	童僕
困著述	困著述
游标卡尺	遊標卡尺
凑合着	湊合著
占德	佔德
谢华后	謝華后
故云	故云
瞪著者	瞪著者
兖	兗
兑	兌
昆山	崑山
铝制	鋁製
发型	髮型
空余	空餘
于伏	於伏
于品海	于品海
忙著者	忙著者
加彭	加蓬
側著述	側著述
鲹	鰺
心系唐	心繫唐
夏历	夏曆
百天后	百天後
营干	營幹
流征	流徵
不食干腊	不食乾腊
只眼	隻眼
一出版	一出版
侵占到	侵占到
划入	劃入
卵与石斗	卵與石鬥
余额	餘額
困著錄	困著錄
鲱	鯡
星期后	星期後
看得著	看得着
澹台	澹臺
诂	詁
多只能	多只能
游憩	遊憩
拙于	拙於
味著錄	味著錄
鲵	鯢
接著	接着
拉著錄	拉著錄
鲷	鯛
于尔里克	于爾里克
呆磕	獃磕
大金发苔	大金髮苔
好斗胆	好斗膽
绷带	繃帶
发妻	髮妻
耀著	耀着
掙著書	掙著書
画着	畫著
琴钟	琴鐘
鲬	鯒
冀著述	冀著述
斗武	鬥武
鲭	鯖
测	測
荧郁	熒鬱
志著名	志著名
學著名	學著名
台布	檯布
于大宝	于大寶
车里	車裡
舍出	捨出
圍著述	圍著述
鲢	鰱
松懈	鬆懈
刮来刮去	刮來刮去
鲤	鯉
准式	準式
紐西蘭	新西蘭
金色长发	金色長髮
数学家	數學家
面食	麵食
連著	連着
郁郁不乐	鬱鬱不樂
坛坛罐罐	罈罈罐罐
心系川	心繫川
跑著作	跑著作
６只	６隻
荡船	蕩船
了若指掌	瞭若指掌
采好	採好
經有云	經有云
７余	７餘
垂范	垂範
修炼	修鍊
全面包围	全面包圍
利欲熏心	利欲熏心
犯不著述	犯不著述
荡舟	蕩舟
楚庄问鼎	楚莊問鼎
夏日裡	夏日裏
郁积	鬱積
着克制	著剋制
立后综	立后綜
纏著稱	纏著稱
颠干倒坤	顛乾倒坤
饥荒	饑荒
占下风	佔下風
慣著作	慣著作
参考价值	參考價值
祭吊文	祭弔文
皱别	皺彆
筑西	筑西
1周后	1周後
渴著錄	渴著錄
疑著名	疑著名
筝	箏
昆苏	崑蘇
敞著述	敞著述
斗法	鬥法
托梦	託夢
双胜类	雙胜類
涂羽卿	涂羽卿
趕著述	趕著述
臣仆	臣僕
抬著作	抬著作
戬	戩
摸钟	摸鐘
代表著書	代表著書
股栗	股慄
余十	餘十
抱素怀朴	抱素懷樸
洗发	洗髮
采摘	採摘
于尽	於盡
风采	風采
算历史	算歷史
白发其事	白發其事
风里	風裡
占至多	佔至多
干哥	乾哥
郁郁菲菲	郁郁菲菲
采摭	採摭
于我	於我
悦	悅
吁请	籲請
变脏	變髒
干纲	乾綱
嫌凶	嫌兇
展著作	展著作
夸诞	夸誕
金表情	金表情
发针	髮針
药味	藥味
幾內亞比索	幾內亞比紹
水里浊水溪	水里濁水溪
莽荡	莽蕩
只身上的	只身上的
们斗了胆	們斗了膽
个中奥妙	箇中奧妙
掙著述	掙著述
川谷	川穀
九扎	九紮
钟表停	鐘錶停
台历史	台歷史
博汇	博彙
打谷	打穀
活著書	活著書
鼗	鞀
金表现	金表現
脑干	腦幹
旧	舊
无	無
飄著錄	飄著錄
一地里	一地裡
旸	暘
3只支援	3只支援
时	時
鼍	鼉
沈海	瀋海
鼋	黿
于穆	於穆
皺著書	皺著書
围	圍
鸡奸	雞姦
丑时	丑時
鼹	鼴
千丝万缕	千絲萬縷
卞庄子	卞莊子
庄农	莊農
回流	迴流
睡著述	睡著述
丑旦	丑旦
丑日	丑日
戰著	戰着
去著名	去著名
葉門	也門
代表著者	代表著者
慣著述	慣著述
毛坏	毛坏
高几	高几
學裡	學裏
𩧱	𩥉
臜	臢
公厘	公釐
打钟	打鐘
肮肮脏脏	骯骯髒髒
小只有	小只有
简筑翎	簡筑翎
回翔	迴翔
語著名	語著名
凶刀	兇刀
材干	材幹
摟著者	摟著者
潮涌	潮湧
朴实	樸實
韬	韜
借以	藉以
笔秃墨干	筆禿墨乾
韩	韓
韨	韍
韧	韌
韦	韋
聞得著	闻得着
钟面	鐘面
谘	諮
韵	韻
私欲	私慾
谞	諝
著它	着它
扯面	扯麵
郁塞	鬱塞
美著者	美著者
因著者	因著者
丑表功	丑表功
倒绷孩儿	倒繃孩兒
刻著書	刻著書
萧参	蕭蔘
饥渴	饑渴
聖露西亞	聖盧西亞
哀吊	哀弔
战	戰
施舍	施捨
珍妮弗·卡普里亚蒂	卡佩雅蒂
斗胜	鬥勝
运	運
连	連
迟	遲
远	遠
违	違
定著名	定著名
进	進
还	還
这	這
过	過
国历任	國歷任
迁	遷
谔	諤
戗	戧
迈	邁
迳	逕
复函数	複函數
谊	誼
蕴含着	蘊含著
斗私批修	鬥私批修
甜著錄	甜著錄
诗云	詩云
两鼠斗穴	兩鼠鬥穴
伊斯兰历	伊斯蘭曆
索马里	索馬里
佣工	傭工
迩	邇
貞著作	貞著作
谍	諜
干甚么	幹甚麼
调	調
吹著名	吹著名
男仆	男僕
仇隙	讎隙
松弛	鬆弛
郭后	郭后
谀	諛
𨱉	鍄
心细如发	心細如髮
着重指出	著重指出
于小偉	于小偉
冷面相	冷面相
沿著錄	沿著錄
占好	佔好
遗范	遺範
刻著名	刻著名
丝发	絲髮
白朴	白樸
徒托空言	徒託空言
悠荡	悠蕩
于仁泰	于仁泰
馬占山	馬占山
涵著書	涵著書
眬	矓
折戟沈河	折戟沈河
白术	白朮
𨱀	𨥛
眦	眥
标致	標緻
夏于喬	夏于喬
冀著書	冀著書
共和历	共和曆
领域里	領域裡
面食面	面食麵
谳	讞
药力	藥力
多占	多佔
吃错药	吃錯藥
心系台	心繫台
跟著述	跟著述
锎	鐦
推托	推託
空著稱	空著稱
飘游	飄遊
圈里	圈裡
批准的	批准的
锊	鋝
挨著述	挨著述
向著者	向著者
松脆	鬆脆
機械系	機械系
佳肴	佳肴
个中原因	箇中原因
郘钟	郘鐘
舍命	捨命
持著錄	持著錄
任教于	任教於
松开	鬆開
卷入	捲入
只身材	只身材
发油	髮油
冉有仆	冉有僕
食欲	食慾
历本	曆本
㛟	𡞵
干校	幹校
著衣	着衣
干不成	幹不成
干结	乾結
戀著書	戀著書
心系和	心繫和
枕著錄	枕著錄
秃妃之发	禿妃之髮
望著者	望著者
河里	河裡
挂钩	掛鈎
干练	幹練
樊于期	樊於期
備著述	備著述
挂钟	掛鐘
干绷	乾繃
公历史	公歷史
斗狠	鬥狠
削面	削麵
刮风后	颳風後
葱郁	蔥鬱
3天后	3天後
順著述	順著述
干圆洁净	乾圓潔淨
高著述	高著述
戰著者	戰著者
游艇	遊艇
近日無仇	近日無讎
杂面	雜麵
药罐	藥罐
谷日	穀日
谷旦	穀旦
游艺	遊藝
绮	綺
余威	餘威
性欲	性慾
馏	餾
浮松	浮鬆
注解	註解
红后假说	紅后假說
注册	註冊
穆罕默德历史	穆罕默德歷史
绣	綉
浑个	渾箇
震荡	震蕩
山崩钟应	山崩鐘應
钟头	鐘頭
景致	景緻
尽管	儘管
懷著者	懷著者
披著錄	披著錄
于梨华	於梨華
于此	於此
选手	選手
贵征	貴徵
绺	綹
本著錄	本著錄
丰容	丰容
藏著錄	藏著錄
意克制	意剋制
于斯达尔	于斯達爾
四出逃	四出逃
折子	摺子
莺	鶯
掌柜	掌柜
汇算	彙算
喂饱	餵飽
于四	於四
沿著名	沿著名
繁钟	繁鐘
郁伊	鬱伊
药理	藥理
喂养	餵養
重游	重遊
靠著录	靠著錄
簡訊	短訊
操作钟	操作鐘
金表演	金表演
松脱	鬆脫
古钟	古鐘
锲而不舍	鍥而不捨
悠著者	悠著者
于国	於國
丑剌剌	醜剌剌
干灯盏	乾燈盞
飞刍挽粟	飛芻輓粟
拿下钟	拿下鐘
3只	3隻
要么	要麼
绉	縐
当准	當準
戰著作	戰著作
薙发	薙髮
终	終
沈郁	沈鬱
掛鉤	掛鈎
吊书	弔書
守著	守着
做著者	做著者
锶	鍶
于克制	於剋制
野游	野遊
於氏	於氏
经	經
纏著作	纏著作
誉	譽
于德海	于德海
求著稱	求著稱
娄	婁
帝后台	帝后臺
赌斗	賭鬥
一出逃	一出逃
誊	謄
干颡	乾顙
𫍰	諰
𫍲	謏
渔	漁
渗	滲
著重	着重
渑	澠
并迭	并迭
渍	漬
渌	淥
厘升	釐升
渎	瀆
白兔擣药	白兔擣藥
渊	淵
盛著者	盛著者
干漆	乾漆
披头散发	披頭散髮
1年	1年
披著名	披著名
折纸	摺紙
面粉碎	面粉碎
𫍙	訑
挥手表	揮手表
冒著錄	冒著錄
弥山遍野	瀰山遍野
𫍟	𧦧
棫朴	棫樸
生发生	生發生
温	溫
娈	孌
賢后	賢后
貞著稱	貞著稱
艸木丰丰	艸木丰丰
溢著作	溢著作
梳著述	梳著述
统	統
拮据	拮据
蜡	蠟
绑	綁
發布	發佈
干完	幹完
美制	美製
二虎相斗	二虎相鬥
干家	幹家
采猎	採獵
绝对参照	絕對參照
髡发	髡髮
頒布	頒佈
蜗	蝸
隨著名	隨著名
踩著名	踩著名
捉奸贼	捉奸賊
通庄	通莊
鲙	鱠
潜水钟表	潛水鐘錶
鲛	鮫
跳著	跳着
鲝	鮺
数	數
鲟	鱘
伴著錄	伴著錄
鲑	鮭
鲒	鮚
鲓	鮳
揮著名	揮著名
鲕	鮞
戰著錄	戰著錄
鲗	鰂
于过	於過
鲉	鮋
鲊	鮓
鲋	鮒
鲌	鮊
鲍	鮑
鲎	鱟
鲏	鮍
鲀	魨
鲁	魯
鲂	魴
鲃	䰾
鲄	魺
鲅	鮁
鲆	鮃
鲇	鯰
鲸	鯨
逆著書	逆著書
鲺	鯴
鲻	鯔
鱼干	魚乾
松饼	鬆餅
鲾	鰏
鲿	鱨
鲰	鯫
丑脸	醜臉
貞著	貞着
鲳	鯧
鲴	鯝
敛	斂
鲶	鯰
没事干	沒事幹
鲨	鯊
鲩	鯇
鲪	鮶
嚷著稱	嚷著稱
懷著錄	懷著錄
冲起	衝起
鲮	鯪
鲯	鯕
鲠	鯁
鲡	鱺
敌	敵
鲣	鰹
敷药	敷藥
鲥	鰣
保障著錄	保障著錄
鲧	鯀
解发佯狂	解髮佯狂
钟模	鐘模
冬天裡	冬天裏
覆水难收	覆水難收
陪著書	陪著書
、克制	、剋制
发光可鉴	髮光可鑑
蝼	螻
淫欲	淫慾
订制	訂製
激荡	激蕩
著意	着意
定著者	定著者
范文	範文
管著書	管著書
细致	細緻
迷于	迷於
发面	發麵
0余	0餘
领袖欲	領袖慾
𫗧	餗
儒略历史	儒略歷史
于０	於０
柱梁	柱樑
春天裡	春天裏
響著名	響著名
裹著者	裹著者
鬒发	鬒髮
游山玩水	遊山玩水
撼著作	撼著作
电子钟	電子鐘
二出祁山	二出祁山
牽著名	牽著名
发蜡	髮蠟
发夹	髮夾
香干	香乾
嚷著	嚷着
捞面	撈麵
诗钟	詩鐘
大明历	大明曆
贾后	賈后
忍著者	忍著者
绩	績
太空梭	穿梭機
绫	綾
绪	緒
续	續
绬	緓
绯	緋
花马吊嘴	花馬弔嘴
绡	綃
绠	綆
綁著作	綁著作
绢	絹
绥	綏
绤	綌
继	繼
绦	絛
绹	綯
绸	綢
绻	綣
粗制	粗製
绽	綻
综	綜
甜著名	甜著名
绾	綰
绱	緔
绰	綽
绳	繩
绲	緄
绵	綿
维	維
绷	綳
绶	綬
大干	大幹
绷着	繃著
绋	紼
绊	絆
绍	紹
绌	絀
得著作	得著作
绎	繹
绁	紲
绀	紺
练	練
绂	紱
绅	紳
组	組
织	織
细	細
给	給
绘	繪
绛	絳
绚	絢
閉著作	閉著作
络	絡
发汗药	發汗藥
绞	絞
逆著稱	逆著稱
绐	紿
结	結
绒	絨
绕	繞
绔	絝
绗	絎
绖	絰
标志	標誌
保障著名	保障著名
选手表决	選手表決
尼日爾	尼日爾
亿天后	億天後
閑著	閑着
干敲梆子不卖油	乾敲梆子不賣油
筑肥	筑肥
徕	徠
干折	乾折
瞄准	瞄準
盲干	盲幹
吕后	呂后
瑞征	瑞徵
径	徑
蜂准	蜂準
斗鸡	鬥雞
喝著書	喝著書
杯面	杯麵
列印	打印
斗鸭	鬥鴨
当当	噹噹
蠁干	蠁幹
干熬	乾熬
𩙩	𩘀
抑郁	抑鬱
淀粉	澱粉
循著名	循著名
吊谎	弔謊
心系十	心繫十
播于	播於
九出祁山	九出祁山
求著作	求著作
𪾢	睍
尸鸠	尸鳩
卷烟	捲煙
风物志	風物誌
暗著者	暗著者
五谷王北街	五谷王北街
多只	多隻
缝制	縫製
采过	採過
藏著述	藏著述
嫁祸于	嫁禍於
采运	採運
于斯	於斯
斥著名	斥著名
叱咤咤	叱咤咤
准不准她	准不准她
除臭药	除臭藥
守著稱	守著稱
肉干	肉乾
裝著述	裝著述
于斌	于斌
钟快	鐘快
船只有	船只有
心系千	心繫千
善于	善於
公仔面	公仔麵
蒙著名	蒙著名
社里	社裡
拒人于	拒人於
征训	徵訓
首只	首隻
后瑞站	后瑞站
首发	首發
髭著書	髭著書
朴鲁	樸魯
伙伴	夥伴
和克制	和剋制
有征討	有征討
看著作	看著作
样范	樣範
侦	偵
四出	四齣
快冲	快衝
并发动	並發動
雜著書	雜著書
坐著者	坐著者
裝著	裝着
心系南	心繫南
对表格	對表格
一个准	一個準
覆盖	覆蓋
二出刊	二出刊
髭著述	髭著述
不占凶吉	不占凶吉
董氏封发	董氏封髮
毫发	毫髮
挑著者	挑著者
于特森	于特森
伊适杰	伊適杰
辦著者	辦著者
于克-兰多县	于克-蘭多縣
秋发	秋髮
回銮	迴鑾
赞许	讚許
藏著者	藏著者
看表面	看表面
持著者	持著者
慣著稱	慣著稱
心系百	心繫百
接著錄	接著錄
胜肽	胜肽
于耘婕	于耘婕
朝著名	朝著名
呒	嘸
皇极历	皇極曆
对表演	對表演
好签	好籤
黄曲霉	黃曲霉
貝里斯	伯利茲
仆虽罢驽	僕雖罷駑
中型钟	中型鐘
旧历	舊曆
瞆	瞶
演著名	演著名
瞒	瞞
仰药	仰藥
谷道	穀道
靥	靨
龙卷	龍捲
阴历史	陰歷史
關著名	關著名
𫐆	轣
靓	靚
𫐄	軏
充饥	充饑
己丑	己丑
瞩	矚
𫐉	軨
來著者	來著者
理完发	理完髮
并网	併網
𫐓	輮
后羿	后羿
诜	詵
𫐐	輗
分子钟	分子鐘
遠著者	遠著者
獨著述	獨著述
肉松	肉鬆
映著錄	映著錄
谷贱伤农	穀賤傷農
并名	併名
身著稱	身著稱
演著書	演著書
撚须	撚鬚
欲壑难填	慾壑難填
𩨐	𩧆
铁杆	鐵杆
蝈	蟈
负债累累	負債纍纍
服于	服於
豮	豶
噜苏	嚕囌
變著作	變著作
人参看	人參看
拒于	拒於
药到命除	藥到命除
好斗笠	好斗笠
望著稱	望著稱
谷米	穀米
卷逃	捲逃
斗来斗去	鬥來鬥去
拭干	拭乾
朝著錄	朝著錄
揮著者	揮著者
𫏋	蹻
澜	瀾
待著	待着
拉面巾	拉面巾
公余	公餘
战天斗地	戰天鬥地
𫛛	鳷
挂号	挂號
窗台	窗檯
數著述	數著述
晒图纸	晒圖紙
盛著稱	盛著稱
螨	蟎
王后	王后
难于	難於
缜致	縝緻
府干	府幹
余桃	餘桃
苦著錄	苦著錄
螀	螿
钟慢	鐘慢
炼贫	鍊貧
云尔	云爾
伥	倀
停制	停製
教学钟	教學鐘
勃郁	勃鬱
冲风	衝風
可自制	可自制
面杖	麵杖
晒晒	晒晒
年历	年曆
方面	方面
打出吊入	打出弔入
余晖	餘暉
埋头寻钟表	埋頭尋鐘錶
须根	鬚根
丑名	醜名
味著作	味著作
八只	八隻
面条	麵條
占座	佔座
隔著名	隔著名
游丝	遊絲
仆欧	僕歐
后平路	后平路
莫三比克	莫桑比克
傧	儐
佥	僉
吊卷	弔卷
有棱有角	有稜有角
夢著錄	夢著錄
汇整	彙整
体	體
偬	傯
幸免	倖免
涂天相	涂天相
斗牌	鬥牌
著裝	着裝
于里察	于里察
党怀英	党懷英
偿	償
会	會
釀著錄	釀著錄
陋著作	陋著作
斗牛	鬥牛
撼著	撼着
优	優
哄动	鬨動
储	儲
０只	０隻
伞	傘
布道	佈道
编制	編製
蜂涌	蜂湧
意面	意麵
于友泽	于友澤
余众	餘眾
忙著錄	忙著錄
滩	灘
生力面	生力麵
余羡	餘羨
遠著錄	遠著錄
彩绸	綵綢
關著	關着
危于	危於
寒假里	寒假裡
拎著述	拎著述
里通外国	裡通外國
准不准	準不準
干瘾	乾癮
祢	禰
疲困	疲睏
废后	廢后
干瘦	乾瘦
死里逃生	死裡逃生
戰著稱	戰著稱
利欲	利慾
干瘪	乾癟
困著者	困著者
诒	詒
将占卜	將占卜
鸿案相庄	鴻案相莊
晾干	晾乾
武斗	武鬥
干熱	乾熱
天后	天后
祃	禡
循著者	循著者
追著	追着
单单于	單單於
祎	禕
个中好手	箇中好手
閉著者	閉著者
隔著錄	隔著錄
干茶钱	乾茶錢
钱范	錢範
阿里	阿里
征占	徵佔
简朴	簡樸
丰仪	丰儀
望着钟表	望著鐘錶
唱游	唱遊
夢著名	夢著名
喂食	餵食
亮著稱	亮著稱
并叠	併疊
于浩威	于浩威
匡复	匡複
悠著書	悠著書
喝著	喝着
中于	中於
棱体	稜體
計程車	的士
杆	桿
苦药	苦藥
索馬利亞	索馬里
磨炼	磨鍊
冲掉	衝掉
多周后	多周後
仆妇	僕婦
冰冷	冰冷
響著書	響著書
岁聿云暮	歲聿云暮
只身世	只身世
尸弃佛	尸棄佛
托孤	託孤
巴布亞紐幾內亞	巴布亞新畿內亞
八出版	八出版
開著錄	開著錄
試著錄	試著錄
十周后	十周後
三复	三複
百药之长	百藥之長
火并	火併
貞著名	貞著名
咸咸	鹹鹹
见素抱朴	見素抱樸
稻谷	稻穀
只身为	只身為
准拿督	準拿督
跑著名	跑著名
朝乾夕惕	朝乾夕惕
干部	幹部
扎好底子	扎好底子
望着钟	望著鐘
萝卜	蘿蔔
夸丽	夸麗
药单	藥單
拉著者	拉著者
敲钟	敲鐘
膠著錄	膠著錄
嘘	噓
騎著述	騎著述
戴著	戴着
4只	4隻
涂長望	涂長望
心系慈	心繫慈
表转	錶轉
枕著述	枕著述
担负着	擔負著
不每只	不每只
占饭	佔飯
能干戈	能干戈
精制	精製
簖	籪
孤寡不谷	孤寡不穀
划来划去	划來划去
发禁	髮禁
咸嘴淡舌	鹹嘴淡舌
松缓	鬆緩
罩著作	罩著作
丰标	丰標
您克制	您剋制
待著書	待著書
咸鸭蛋	鹹鴨蛋
辟划	闢劃
睡不著	睡不着
大赞	大讚
发雕	髮雕
后髮FK型星	后髮FK型星
志著書	志著書
袋表	袋錶
提著者	提著者
向着	向著
定著錄	定著錄
瞞著述	瞞著述
6只	6隻
待著稱	待著稱
计时表	計時錶
谬赞	謬讚
阴沟里翻船	陰溝裡翻船
四出祁山	四出祁山
请君入瓮	請君入甕
采纳	採納
人参透	人參透
一伙人	一伙人
人参选	人參選
铻	鋙
瘅	癉
挽詞	輓詞
铸	鑄
铿	鏗
链	鏈
五周后	五周後
铼	錸
铳	銃
铲	鏟
铱	銥
铰	鉸
铷	銣
银	銀
铵	銨
铴	鐋
铫	銚
铪	鉿
铩	鎩
铨	銓
铯	銫
铮	錚
铭	銘
铬	鉻
铣	銑
铢	銖
铡	鍘
铠	鎧
铧	鏵
铦	銛
铥	銩
铤	鋌
盯著名	盯著名
铚	銍
铙	鐃
铘	鋣
铟	銦
铞	銱
铝	鋁
铜	銅
铓	鋩
铒	鉺
铑	銠
铐	銬
铗	鋏
铖	鋮
铕	銪
铔	錏
铋	鉍
铊	鉈
铉	鉉
铈	鈰
铏	鉶
铎	鐸
來著書	來著書
铌	鈮
铃	鈴
铂	鉑
铁	鐵
瘿	癭
铇	鉋
铆	鉚
于明濤	于明濤
铄	鑠
涂姓	涂姓
惇朴	惇樸
干凉	乾涼
冲力	衝力
干净	乾淨
甜著稱	甜著稱
䶮	龑
何杰	何杰
采种	採種
唯一只	唯一只
着书立说	著書立說
冲劲	衝勁
逼著	逼着
农药	農藥
于楓	于楓
轉著	轉着
高干预	高干預
秒表示	秒表示
才干涉	才干涉
十出版	十出版
世界杯	世界盃
巴尔干	巴爾幹
應著名	應著名
纺	紡
冲动	衝動
强	強
朝著者	朝著者
心系英	心繫英
駕著者	駕著者
炼金术	鍊金術
舍己为公	捨己為公
沿著稱	沿著稱
吊贺迎送	弔賀迎送
弯	彎
麗著錄	麗著錄
气冲斗牛	氣沖斗牛
张	張
弥	彌
鬥著者	鬥著者
㱩	殰
㱮	殨
参与感	參與感
咳嗽药	咳嗽藥
弑	弒
耀著稱	耀著稱
异	異
弃	棄
开	開
眼睛裡	眼睛裏
付托	付託
野姜	野薑
面食饭	面食飯
一扎	一紮
云南白药	雲南白藥
苦著名	苦著名
心系募	心繫募
航海历史	航海歷史
老蒙	老懞
隔著者	隔著者
天翻地覆	天翻地覆
望后石	望后石
食面	食麵
御侮	禦侮
周后	周后
渴著稱	渴著稱
受著述	受著述
𩾎	𩽇
飄著者	飄著者
紫姜	紫薑
仇夷	讎夷
心著	心着
語著者	語著者
據著	據着
科学家	科學家
射雕	射鵰
紮著者	紮著者
丑剧	醜劇
身体发肤	身體髮膚
凝炼	凝鍊
側著稱	側著稱
曝晒	曝晒
機器人	機械人
慣著書	慣著書
心系宣	心繫宣
定著稱	定著稱
埘	塒
吊古	弔古
挽诗	輓詩
俫	倈
人参政	人參政
合伙人	合伙人
俭	儉
合着	合著
心系家	心繫家
布希	布殊
喝著稱	喝著稱
有发头陀寺	有髮頭陀寺
囉苏	囉囌
芒果干	芒果乾
解铃仍须系铃人	解鈴仍須繫鈴人
心系它	心繫它
数字钟表	數字鐘錶
脚炼	腳鍊
爆发指数	爆發指數
模范14棒	模范14棒
悬梁	懸樑
埯	垵
鄭凱云	鄭凱云
后台老板	後台老板
陋著	陋着
涂敏恆	涂敏恆
哥斯大黎加	哥斯達黎加
须鲸	鬚鯨
脱谷机	脫穀機
整只	整隻
就范	就範
涂敏恒	涂敏恆
只身受	只身受
商历史	商歷史
欲障	慾障
人欲	人慾
剥制	剝製
屋子里	屋子裡
秋千	鞦韆
卷轴	捲軸
万个	萬個
并力	并力
折冲	折衝
掙著錄	掙著錄
暗里	暗裡
云游	雲遊
远游	遠遊
康著名	康著名
蓊郁	蓊鬱
千只足夠	千只足夠
當著書	當著書
六余	六餘
欢	歡
代表著名	代表著名
疲于	疲於
掖著作	掖著作
泄欲	洩慾
欤	歟
斗地主	鬥地主
蚬	蜆
采伐	採伐
定著	定着
活著名	活著名
想著名	想著名
将占	將佔
旧历史	舊歷史
山梁	山樑
积极参加	積极參加
賈后	賈后
谷圭	穀圭
斯洛維尼亞	斯洛文尼亞
李連杰	李連杰
乾象历	乾象曆
大衍历	大衍曆
相并	相併
看着表	看著錶
相干	相干
寒栗	寒慄
拿准	拿準
制浆	製漿
暧	曖
守著者	守著者
苦斗	苦鬥
釀著述	釀著述
掖著稱	掖著稱
于民	於民
奏折	奏摺
醯酱	醯醬
冲撞	衝撞
惊赞	驚讚
征友	徵友
征发	徵發
穿著名	穿著名
痪	瘓
戴著作	戴著作
二仑	二崙
摇荡	搖蕩
望著述	望著述
征召	徵召
干馏	乾餾
范式	範式
纤夫	縴夫
跟著錄	跟著錄
制得	製得
代表著述	代表著述
谷舱	穀艙
余思	餘思
作庄	作莊
一锅面	一鍋麵
鹅准	鵝準
漤	灠
凶徒	兇徒
十只	十隻
背著書	背著書
亮著述	亮著述
擋著者	擋著者
匏系	匏繫
不加自制	不加自制
干上	幹上
九年	九年
众	眾
六周后	六周後
得著錄	得著錄
卷心菜	捲心菜
过水面	過水麵
在著述	在著述
干丝	乾絲
九出口	九出口
厄瓜多尔	厄瓜多爾
擋著名	擋著名
钟鼓	鐘鼓
钟鼎	鐘鼎
吊慰	弔慰
萨	薩
新扎	新紮
暂	暫
萧	蕭
萦	縈
营	營
递回	遞迴
游宦	遊宦
；克制	；剋制
萝	蘿
亮著錄	亮著錄
鹆	鵒
臨著稱	臨著稱
炼形	鍊形
余步	餘步
对于	對於
结伴同游	結伴同遊
鹁	鵓
于軍	于軍
点多钟	點多鐘
赞佩	讚佩
能干涉	能干涉
郁律	鬱律
伙计	夥計
打干	打幹
视于	視於
逼著錄	逼著錄
花盆里	花盆裡
䜣	訢
渴著述	渴著述
壓著	壓着
䜧	譅
上签	上籤
䜥	𧩙
显示表	顯示錶
哭著	哭着
灰蒙蒙	灰濛濛
涂謹申	涂謹申
沉著者	沉著者
晋	晉
范文正公	范文正公
痒	癢
占卜	占卜
晒	曬
著急	着急
蒙著者	蒙著者
晖	暉
长胡	長鬍
晔	曄
晕	暈
丑丑	醜醜
頂著作	頂著作
吊丧	弔喪
生发	生髮
吃著	吃着
发际	髮際
翻松	翻鬆
貞著錄	貞著錄
看著名	看著名
咸类	鹹類
余窍	餘竅
高著稱	高著稱
記著名	記著名
毛姜	毛薑
乘著錄	乘著錄
求著名	求著名
通历史	通歷史
開著者	開著者
吊诡矜奇	弔詭矜奇
點著	點着
心系美	心繫美
有著	有着
吹著錄	吹著錄
鬥著	鬥着
干死	乾死
接著述	接著述
晒衣	晒衣
四余	四餘
几个	幾個
垄断集团	壟斷集團
划了	划了
帶著書	帶著書
身著者	身著者
占四	佔四
于湘兰	于湘蘭
遠著稱	遠著稱
卖呆	賣獃
历法	曆法
心系群	心繫群
几丝	几絲
唇干	唇乾
易于	易於
参与	參與
总裁制	總裁制
仗著書	仗著書
配著述	配著述
几上	几上
害于	害於
逆钟	逆鐘
與著書	與著書
心系山	心繫山
耿于	耿於
格里高利历	格里高利曆
流风余韵	流風餘韻
怪里怪气	怪裡怪氣
踩著作	踩著作
秽	穢
惧	懼
穿著稱	穿著稱
庆吊	慶弔
泻药	瀉藥
快快当当	快快當當
惨	慘
汤团	湯糰
准度	準度
聖克里斯多福及尼維斯	聖吉斯納域斯
积	積
国历届	國歷屆
循著錄	循著錄
春假里	春假裡
鹎	鵯
历始	曆始
盛著述	盛著述
懷著作	懷著作
嗅不著	嗅不着
干咳	乾咳
部落发	部落發
静	靜
騎著	騎着
罩著名	罩著名
秃	禿
种	種
于后	於後
于非闇	于非闇
干地	乾地
打著稱	打著稱
光著名	光著名
干的	乾的
在克制	在剋制
役于	役於
揮著稱	揮著稱
捉奸细	捉奸細
系辞	繫辭
制革	製革
扫	掃
山谷道	山谷道
页面	頁面
鹈	鵜
庞	龐
废	廢
横征暴敛	橫徵暴斂
墓志铭	墓志銘
朴樕	樸樕
应	應
干咽	乾咽
字汇	字彙
庐	廬
㳠	澾
库	庫
馊	餿
六谷	六穀
炸药	炸藥
绨	綈
余闰	餘閏
達著述	達著述
信著稱	信著稱
狂并潮	狂併潮
守著述	守著述
伴著述	伴著述
肉羹面	肉羹麵
睡着了	睡著了
蒙著書	蒙著書
晃著稱	晃著稱
干探	幹探
乘著作	乘著作
駕著稱	駕著稱
杂志	雜誌
閉著稱	閉著稱
若干	若干
獲著者	獲著者
醜著	醜着
涂澤民	涂澤民
博采	博採
帶著名	帶著名
滩涂	灘涂
摄制	攝製
食野之苹	食野之苹
并发展	並發展
补注	補註
干和	乾和
么么小丑	么麼小丑
这只是	這只是
鹔	鷫
杀虫药	殺蟲藥
窝	窩
直于	直於
党太尉	党太尉
順著名	順著名
刘佳怜	劉佳怜
之钟	之鐘
被里	被裡
郁堙不偶	鬱堙不偶
柜子	柜子
光著錄	光著錄
诙	詼
志著者	志著者
游冶	遊冶
夸人	夸人
止于	止於
爭著述	爭著述
敲扑	敲扑
庄士顿道	莊士頓道
干道	幹道
电码表	電碼表
也克制	也剋制
制冰	製冰
制冷	製冷
闫怀礼	閆懷禮
形影相吊	形影相弔
只身前	只身前
其余	其餘
中国国际信托投资公司	中國國際信托投資公司
采樵人	採樵人
夸容	夸容
赞歌	讚歌
干什么	幹什麼
铯钟	銫鐘
并到	併到
皮制服	皮制服
尋著錄	尋著錄
砰当	砰噹
三准	三準
努著	努着
那只在	那只在
封后	封后
托运	託運
于成龍	于成龍
幫著述	幫著述
循著稱	循著稱
籴	糴
于成龙	于成龍
棱角	稜角
征文	徵文
瞧着钟表	瞧著鐘錶
面包	麵包
里通外敌	裡通外敵
员山庄	員山庄
尸罗精舍	尸羅精舍
制图	製圖
邹	鄒
鲇鱼	鯰魚
繞著錄	繞著錄
六只	六隻
雜著錄	雜著錄
棺材里	棺材裡
鼠药	鼠藥
于海洋	于海洋
几筵	几筵
抗癌药	抗癌藥
朱批	硃批
气郁	氣鬱
皑	皚
钟不敲不响	鐘不敲不響
𫔎	鐍
勤朴	勤樸
９天后	９天後
裹著作	裹著作
亦云	亦云
搋面	搋麵
仆射	僕射
皲	皸
旧表	舊錶
皱	皺
很凶	很兇
纏著書	纏著書
赡	贍
赢	贏
赣	贛
钟有	鐘有
反复	反覆
小只可	小只可
赵	趙
赶	趕
沈阳	瀋陽
并产	併產
丝线	絲線
学里	學裡
宗周钟	宗周鐘
资	資
摟著稱	摟著稱
赆	贐
赇	賕
赀	貲
赁	賃
赂	賂
寫著者	寫著者
赌	賭
赍	齎
赎	贖
赏	賞
赈	賑
赉	賚
赊	賒
赋	賦
赔	賠
赕	賧
赖	賴
加氢精制	加氫精制
赐	賜
赑	贔
赒	賙
赓	賡
赜	賾
赝	贗
赞	贊
赟	贇
塞席爾	塞舌爾
赙	賻
住著作	住著作
赛	賽
毕业于	畢業於
大型钟面	大型鐘面
漫著者	漫著者
展著	展着
梿	槤
梾	棶
干人	幹人
梼	檮
干产	乾產
松绑	鬆綁
梦	夢
美著書	美著書
研制	研製
舍死忘生	捨死忘生
側著書	側著書
大曲	大麴
淫荡	淫蕩
本著述	本著述
干些	幹些
干了	幹了
飄著述	飄著述
隔著稱	隔著稱
不斗	不鬥
阳历	陽曆
并吞下	併吞下
摇摇荡荡	搖搖蕩蕩
跳著錄	跳著錄
藝著者	藝著者
扎囮	紮囮
配合着	配合著
恳托	懇託
聽著述	聽著述
谷类	穀類
七出口	七出口
太初历	太初曆
范文照	范文照
北回线	北迴線
挨著	挨着
蒌	蔞
蒉	蕢
蒋	蔣
于光远	于光遠
光著稱	光著稱
蒇	蕆
干娘	乾娘
楚庄绝缨	楚莊絕纓
跳著作	跳著作
逼著者	逼著者
郁邑	鬱邑
书面	書面
心长发短	心長髮短
應著者	應著者
止血药	止血藥
殖谷	殖穀
当当丁丁	當當丁丁
蛇发女妖	蛇髮女妖
药害	藥害
赞颂	讚頌
卷土重来	捲土重來
绿	綠
六出版	六出版
抓著稱	抓著稱
块	塊
坝	壩
坜	壢
坟	墳
坞	塢
坐著作	坐著作
乱	亂
坛	壇
坚	堅
嬴余	嬴餘
六出生	六出生
水里乡	水里鄉
倦游	倦遊
书	書
习	習
乡	鄉
布庄	布莊
美著稱	美著稱
行著稱	行著稱
乐	樂
给于	給於
乌	烏
反复制	反複製
梳著稱	梳著稱
义	義
康著者	康著者
臨著書	臨著書
淡朱	淡硃
余粮	餘糧
积淀	積澱
船只得	船只得
站著者	站著者
家具行	家具行
零年	零年
暑假里	暑假裡
分布圖	分布圖
划为	劃為
于会泳	于會泳
獲著作	獲著作
于化虎	于化虎
猜三划五	猜三划五
划下	划下
划上	划上
遗传钟	遺傳鐘
凶器	兇器
舍弃	捨棄
石英钟	石英鐘
硷	礆
涂鴻欽	涂鴻欽
犯不著名	犯不著名
八出祁山	八出祁山
重于	重於
樂著錄	樂著錄
确	確
褴	襤
查德	乍得
拿著	拿着
馄饨面	餛飩麵
硙	磑
硗	磽
硖	硤
硕	碩
崄	嶮
表针	錶針
要冲	要衝
冀著稱	冀著稱
救药	救藥
硁	硜
础	礎
干起来	幹起來
择	擇
制著述	制著述
铜范	銅範
于坚	于堅
李志喜	李志喜
游荡不归	遊蕩不歸
穗帏飘井干	繐幃飄井幹
對著作	對著作
于坏	於坏
县里	縣裡
下仑路	下崙路
姜文杰	姜文杰
注脚	註腳
鹮	䴉
呜	嗚
才干扰	才干擾
不干預	不干預
相克制	相克制
好呆	好獃
鹩	鷯
蘸著稱	蘸著稱
七出逃	七出逃
康著書	康著書
仗著稱	仗著稱
游错	遊錯
上签写	上簽寫
理次发	理次髮
晒图	晒圖
冲冠发怒	沖冠髮怒
准新娘	準新娘
附著錄	附著錄
鋪著稱	鋪著稱
死于	死於
绝于	絕於
尸谏	尸諫
趕著書	趕著書
杂合面儿	雜合麵兒
心繫著	心繫着
三出逃	三出逃
面包罗	面包羅
捆著者	捆著者
占澳	佔澳
谷人	穀人
挥杆	揮杆
秋日裡	秋日裏
夢著	夢着
郁症	鬱症
豫著稱	豫著稱
晒烟	晒煙
息交绝游	息交絕遊
基于	基於
课余	課餘
奖杯	獎盃
细如发	細如髮
刮胡	刮鬍
个钟	個鐘
面价	麵價
采空区	採空區
浪荡	浪蕩
于帅	于帥
不干她	不干她
文征明	文徵明
于市	於市
郁蒸	鬱蒸
钟山	鐘山
铲头	剷頭
鹴	鸘
姜片	薑片
山重水复	山重水複
似于	似於
天文历表	天文曆表
脏水	髒水
复数	複數
横梁	橫樑
齐庄	齊莊
格斗	格鬥
帶著稱	帶著稱
䞐	賰
复字键	複字鍵
刻著	刻着
轉著錄	轉著錄
干奴才	乾奴才
民乐	中樂
䞌	𧵳
排骨面	排骨麵
一天后	一天後
余毒	餘毒
于鳳至	于鳳至
敦朴	敦樸
十年	十年
躍著稱	躍著稱
淋余土	淋餘土
髭著稱	髭著稱
在著名	在著名
吊宴	弔宴
占据	佔據
一哄而散	一鬨而散
疑著錄	疑著錄
信著名	信著名
曲院	麴院
嘱托	囑託
别口气	彆口氣
制签	制籤
复变函数	複變函數
只占吉	只占吉
柜	櫃
弄鬼吊猴	弄鬼弔猴
绣毯	繡毯
占马	佔馬
柠	檸
升阳	昇陽
甄后	甄后
损于	損於
萬一只	萬一只
分子云	分子雲
柽	檉
幫著稱	幫著稱
拉著名	拉著名
踏著錄	踏著錄
焕	煥
裡面	裏面
焘	燾
占道	佔道
百谷	百穀
余7	餘7
表盘	錶盤
雇佣	僱傭
须胡	鬚鬍
容范	容範
内哄	內鬨
钩	鉤
折篷	摺篷
洒家	洒家
被发入山	被髮入山
口燥唇干	口燥唇乾
小只能	小只能
冲压	衝壓
馓	饊
火折子	火摺子
跻	躋
跸	蹕
跹	躚
跶	躂
跷	蹺
践	踐
冲去	衝去
占便宜的是呆	占便宜的是獃
昂著述	昂著述
占床	佔床
闯	闖
问	問
闭	閉
闬	閈
闫	閆
闪	閃
闩	閂
门	門
闷	悶
累绁	纍紲
闵	閔
间	間
闳	閎
采盐	採鹽
闱	闈
闰	閏
闿	闓
闾	閭
闽	閩
闼	闥
闻	聞
闺	閨
闹	鬧
闸	閘
靠著称	靠著稱
头里	頭裡
药剂	藥劑
寮采	寮寀
干量	乾量
宽宽松松	寬寬鬆鬆
干重	乾重
冬冬鼓	鼕鼕鼓
弘历	弘曆
昆调	崑調
下药	下藥
記著者	記著者
于凤至	于鳳至
去著錄	去著錄
渴著	渴着
范围	範圍
勺药	勺藥
盯著作	盯著作
生华发	生華髮
质朴	質樸
欺蒙	欺矇
帅	帥
奋斗	奮鬥
币	幣
帏	幃
庄舄越吟	莊舄越吟
干笑	乾笑
师	師
纡回	紆迴
忧郁	憂鬱
历物之意	厤物之意
帐	帳
待复	待覆
帜	幟
帘	簾
带	帶
帧	幀
大笨钟	大笨鐘
阳春面	陽春麵
占新	佔新
狐借虎威	狐藉虎威
9只支持	9只支持
于国桢	于國楨
帱	幬
布希亞	布希亞
帼	幗
布希亚	布希亞
帻	幘
这只可	這只可
感于	感於
躺著書	躺著書
蒙著	蒙着
花卷	花捲
咸批	鹹批
騙著錄	騙著錄
选手表明	選手表明
打干哕	打乾噦
伪药	偽藥
止咳药	止咳藥
食欲不振	食欲不振
印著作	印著作
暗著稱	暗著稱
别辟	別闢
不干不净	不乾不淨
万扎	萬紮
励	勵
绝	絕
劳	勞
小丑	小丑
奥占	奧佔
腊毒	腊毒
剪彩	剪綵
蓄胡	蓄鬍
諾魯	瑙魯
留著書	留著書
占满	佔滿
變著稱	變著稱
干热	乾熱
有著者	有著者
人参战	人參戰
国	國
一准	一準
想著述	想著述
精炼	精鍊
肴馔	肴饌
囱	囪
园	園
４周后	４周後
刮雪	颳雪
一天钟	一天鐘
赞辞	讚辭
馅	餡
４余	４餘
奈及利亞	尼日利亞
五余	五餘
精制住	精制住
趴著者	趴著者
于时	於時
撞钟	撞鐘
其次辟地	其次辟地
闲荡	閒蕩
朝钟	朝鐘
雜著述	雜著述
面粉	麵粉
办	辦
開著述	開著述
诉说着	訴說著
于澤爾	于澤爾
附于	附於
冲散	衝散
浪游	浪遊
认准	認準
栉发工	櫛髮工
看不著	看不着
采为	採為
台钟	台鐘
干落	乾落
薴烯	薴烯
采下	採下
于海	于海
赠	贈
买凶	買兇
逍遥游	逍遙遊
馁	餒
荐居	荐居
争奇斗异	爭奇鬥異
范畴	範疇
蔂	虆
于飛島	于飛島
弄丑	弄醜
注定	註定
想著稱	想著稱
复复	複復
划过去	划過去
托庇	託庇
折奏	摺奏
赌台	賭檯
不干预	不干預
髭须	髭鬚
准保释	准保釋
蔷	薔
踊	踴
蔼	藹
群丑	群醜
蔺	藺
蔹	蘞
跑著書	跑著書
趴著作	趴著作
律历志	律曆志
游离票	遊離票
里面包	裡面包
馌	饁
打着钟	打著鐘
站著錄	站著錄
尋著	尋着
波札那	博茨瓦納
埃荣冲	埃榮衝
一物克一物	一物剋一物
馍	饃
奇迹	奇蹟
样	樣
仅	僅
南岳	南嶽
从	從
栾	欒
哭著名	哭著名
那只是	那只是
面粉红	面粉紅
仓	倉
辽沈	遼瀋
逼著作	逼著作
庄园	莊園
穷于	窮於
赞呗	讚唄
苹果干	蘋果乾
凶狠	兇狠
捞干	撈乾
树	樹
六出刊	六出刊
煎面	煎麵
们	們
仪	儀
偻	僂
栅	柵
价	價
标	標
勾干	勾幹
栀	梔
泡麵	即食麵
栌	櫨
守著名	守著名
栎	櫟
栉	櫛
栈	棧
栋	棟
栊	櫳
踏著稱	踏著稱
两扎	兩紮
东冲西突	東衝西突
活著作	活著作
偾	僨
远县才至	遠縣纔至
梨干	梨乾
變著	變着
干妹	乾妹
松掉	鬆掉
仆使	僕使
藏著名	藏著名
侵占罪	侵占罪
漫著稱	漫著稱
干妈	乾媽
乘著述	乘著述
美著述	美著述
照著作	照著作
踪	蹤
０天后	０天後
很干	很乾
䘛	𧝞
獨著書	獨著書
厨余	廚餘
余桶	餘桶
趴著錄	趴著錄
骠	驃
骡	騾
选手表现	選手表現
骣	驏
骤	驟
骥	驥
骦	驦
骧	驤
去著作	去著作
其一只	其一只
骐	騏
骑	騎
站著名	站著名
蒙着锅儿	矇著鍋兒
骔	騌
骕	驌
骖	驂
骗	騙
骘	騭
骙	騤
語著作	語著作
骛	騖
骜	驁
骝	騮
骞	騫
田里	田裡
骀	駘
骁	驍
骂	罵
骃	駰
骄	驕
骅	驊
骆	駱
骇	駭
骈	駢
栋梁	棟樑
骊	驪
骋	騁
验	驗
骍	騂
丑杂	醜雜
骏	駿
药签	藥籤
二極體	二極管
发长	髮長
杂	雜
权	權
杀	殺
干刍	乾芻
白胡	白鬍
蚊动牛斗	蚊動牛鬥
亮著者	亮著者
恕乏价催	恕乏价催
苏昆	蘇崑
含著錄	含著錄
杩	榪
力拼众敌	力拼眾敵
条	條
提心吊胆	提心弔膽
分半钟	分半鐘
雅著作	雅著作
诔赞	誄讚
然身死才数月耳	然身死纔數月耳
见于	見於
擺著	擺着
豫著	豫着
五出	五齣
杰	傑
幫著者	幫著者
杞宋无征	杞宋無徵
罩著書	罩著書
百花历	百花曆
云笈七签	雲笈七籤
不干事	不干事
消肿药	消腫藥
干池	乾池
写字台	寫字檯
连占	連佔
心系红	心繫紅
８年	８年
呆着	獃著
㨫	㩜
努力著	努力着
签着	簽著
录制	錄製
盆吊	盆弔
正当着	正當著
面皮	麵皮
精松	精鬆
寶獅	標致
乘著稱	乘著稱
擺著作	擺著作
連著稱	連著稱
見著作	見著作
保障著	保障着
涵著稱	涵著稱
踩著錄	踩著錄
壓著作	壓著作
天干地支	天干地支
蒙瞍	矇瞍
杰威爾音樂	杰威爾音樂
丧钟	喪鐘
预制	預製
钟表盘	鐘錶盤
荡产	蕩產
雇用	僱用
忍著作	忍著作
雅范	雅範
并发重症	併發重症
洒脱	洒脫
不准它	不准它
吊着	吊著
加注	加註
潤著名	潤著名
托买	託買
丑奴儿	醜奴兒
笑著名	笑著名
伊斯兰教历史	伊斯蘭教歷史
额征	額徵
朱理安历	朱理安曆
划行	划行
钟差	鐘差
困著作	困著作
标准	標準
眼睛里	眼睛裡
没干	沒幹
汹涌	洶湧
霉毒	黴毒
著筆	着筆
布谷鸟钟	布穀鳥鐘
轻松	輕鬆
石几	石几
心系兰	心繫蘭
自制之力	自制之力
还冲	還衝
扛著者	扛著者
准货币	準貨幣
八周后	八周後
心系全	心繫全
曾朴	曾樸
担着	擔著
板荡	板蕩
心系众	心繫眾
吁求	籲求
心系伊	心繫伊
才可容颜十五余	纔可容顏十五餘
铺锦列绣	鋪錦列繡
昊天不吊	昊天不弔
采拾	採拾
新历史	新歷史
光著書	光著書
擋著作	擋著作
自制他	自制他
余辜	餘辜
點著名	點著名
于征	於徵
抓著錄	抓著錄
心系传	心繫傳
罵著作	罵著作
祸	禍
复以百万	複以百萬
碰钟	碰鐘
妖后	妖后
抱著名	抱著名
明里	明裡
星历	星曆
涂泽民	涂澤民
燒著名	燒著名
淀乃不耕之地	澱乃不耕之地
条干	條幹
伊斯兰教历	伊斯蘭教曆
存折	存摺
于枫	于楓
朴质	樸質
节欲	節慾
遇风后	遇風後
四只	四隻
戏彩娱亲	戲綵娛親
三極體	三極管
日历	日曆
顶多	頂多
采气	採氣
余膏	餘膏
涌现	湧現
后海灣	后海灣
牽著錄	牽著錄
叙说着	敘說著
陪著錄	陪著錄
于军	于軍
舍己从人	捨己從人
面缸	麵缸
划算	划算
置言成范	置言成範
于冕	于冕
抿发	抿髮
拖著名	拖著名
祯	禎
日晒	日晒
松宽	鬆寬
仙药	仙藥
仇校	讎校
百科裡	百科裏
心系灾	心繫災
于法	於法
舂谷	舂穀
猛冲	猛衝
赅	賅
巧历	巧曆
彩船	綵船
于波	于波
笑著稱	笑著稱
占资源	佔資源
斥著錄	斥著錄
望著作	望著作
干撇下	乾撇下
小米面	小米麵
𫘨	騠
𫘤	騃
𫘣	駻
占ｑ	佔ｑ
𫘝	駃
回响	迴響
干这种事	幹這種事
五出口	五出口
哭著者	哭著者
游仙	遊仙
病愈	病癒
撼著稱	撼著稱
妇	婦
拿破仑	拿破崙
镈	鎛
脏东西	髒東西
镊	鑷
镍	鎳
镌	鐫
镏	鎦
镎	鎿
镁	鎂
镀	鍍
镃	鎡
镂	鏤
镅	鎇
氤郁	氤鬱
镇	鎮
镆	鏌
镙	鏍
镘	鏝
镛	鏞
镚	鏰
镝	鏑
镜	鏡
镟	鏇
镞	鏃
于克勒	于克勒
幸于	幸於
镓	鎵
镒	鎰
镕	鎔
镔	鑌
镗	鏜
镖	鏢
西历史	西歷史
镨	鐠
镫	鐙
镪	鏹
镭	鐳
镬	鑊
镯	鐲
镮	鐶
镡	鐔
镠	鏐
皱折	皺摺
镢	钁
镥	鑥
镤	鏷
镧	鑭
镦	鐓
平平当当	平平當當
行于	行於
长	長
猜著述	猜著述
镱	鐿
镰	鐮
镳	鑣
准不准它	准不准它
鉴于	鑒於
镴	鑞
镶	鑲
淡于	淡於
三余	三餘
迷幻药	迷幻藥
于謙	于謙
历象	曆象
油斗	油鬥
扎紧	紮緊
楊雅筑	楊雅筑
克复	克複
捆著	捆着
整发用品	整髮用品
打吨	打吨
劣于	劣於
騙著述	騙著述
绣球	繡球
钟腰	鐘腰
衣著書	衣著書
暗著述	暗著述
性著稱	性著稱
榉	櫸
榈	櫚
榇	櫬
榅	榲
榄	欖
干头	幹頭
避孕药	避孕藥
复钱	複錢
音准	音準
4周后	4周後
跑著稱	跑著稱
尋著作	尋著作
卤味	滷味
鬥著書	鬥著書
順著錄	順著錄
划具	划具
出戏	齣戲
木材干馏	木材乾餾
仆仆	僕僕
发上指冠	髮上指冠
仆从	僕從
有够赞	有夠讚
药油	藥油
膏药	膏藥
拉著述	拉著述
划着	划著
人参展	人參展
占ｊ	佔ｊ
相斗	相鬥
夸脱	夸脫
皺著作	皺著作
行凶	行兇
仿佛	彷彿
昆仑山脉	崑崙山脈
住著名	住著名
余俗	餘俗
中签	中籤
改征	改徵
瓷制	瓷製
洗炼	洗鍊
翱游	翱遊
复分解	複分解
水无怜奈	水無怜奈
盐	鹽
斗叶子	鬥葉子
发胶	髮膠
于根偉	于根偉
黄钟	黃鐘
于学忠	于學忠
仗著	仗着
聽著名	聽著名
曲生	麴生
噜	嚕
楚庄王	楚莊王
身著	身着
发式	髮式
斗哄	鬥鬨
弱水三千只取一瓢	弱水三千只取一瓢
拼著述	拼著述
二余	二餘
心系社	心繫社
姜汤	薑湯
悠著名	悠著名
华严钟	華嚴鐘
于飞岛	于飛島
疴	痾
分钟	分鐘
坱郁	坱鬱
蘸著名	蘸著名
触须	觸鬚
好困	好睏
造钟	造鐘
映著者	映著者
古書云	古書云
蒙眬	矇矓
寫著書	寫著書
趴著稱	趴著稱
卷云	捲雲
吊裤	吊褲
蚁后	蟻后
衣著錄	衣著錄
梯冲	梯衝
舆	輿
五谷王南街	五谷王南街
干馆	乾館
涂谨申	涂謹申
海湾布雷	海灣佈雷
尸利	尸利
呆事	獃事
已占卜	已占卜
𫓧	鈇
呆人	獃人
漓江	灕江
薮	藪
面疙瘩	麵疙瘩
制法	製法
給我干脆	給我干脆
才则	纔則
余裕	餘裕
拼死	拚死
苦裡	苦裏
判断发	判斷發
药皂	藥皂
秋假里	秋假裡
采花	採花
胡须	鬍鬚
疟	瘧
隐几	隱几
于始	於始
保障著書	保障著書
樂著作	樂著作
毁于	毀於
征兆	徵兆
敢斗了胆	敢斗了膽
冲然	衝然
症状	癥狀
划拳	划拳
揉著作	揉著作
征兵	徵兵
丑声远播	醜聲遠播
抱著者	抱著者
挂念	挂念
求道于盲	求道於盲
于强	於強
拨谷	撥穀
潤著	潤着
于弱	於弱
心系重	心繫重
征募	徵募
忍著錄	忍著錄
拿著述	拿著述
贵干	貴幹
霭	靄
占加	佔加
膠著者	膠著者
連著書	連著書
于漢超	于漢超
浮于	浮於
涂绍煃	涂紹煃
躍著述	躍著述
痊愈	痊癒
采去	採去
挽歌	輓歌
哄堂	鬨堂
长几	長几
嘉肴	嘉肴
盯著錄	盯著錄
克羅埃西亞	克羅地亞
雇人	僱人
咸蛋	鹹蛋
干路	幹路
臨著述	臨著述
语有云	語有云
轻轻松松	輕輕鬆鬆
西米谷	西米谷
赘	贅
由余	由余
占着	佔著
变征	變徵
筛	篩
筚	篳
獄裡	獄裏
的长发	的長髮
筜	簹
丑贼生	醜賊生
筑	築
衣索比亞	埃塞俄比亞
吊死问疾	弔死問疾
理发	理髮
叶韵	叶韻
钟不空则哑	鐘不空則啞
叫著稱	叫著稱
昆仑山	昆崙山
叶音	叶音
筹	籌
签	簽
筼	篔
聽不著	聽不着
余震	餘震
于祂	於祂
术赤	朮赤
8只支持	8只支持
筑邦	筑邦
維德角	佛得角
吊死问孤	弔死問孤
犯不著書	犯不著書
汇报	彙報
于式枚	于式枚
着录	著錄
辞汇	辭彙
惊	驚
百花历史	百花歷史
御敌	禦敵
两天晒网	兩天晒網
壹郁	壹鬱
懷著	懷着
余霞	餘霞
𨸂	閍
𨸃	閐
不准翻印	不准翻印
惩	懲
惫	憊
惬	愜
惭	慚
惮	憚
展著錄	展著錄
藏著	藏着
呆致致	呆緻緻
黏著名	黏著名
所云	所云
谷雨	穀雨
扑挞	扑撻
苦著	苦着
钟摆	鐘擺
拼著名	拼著名
并除	併除
代表著錄	代表著錄
亮钟	亮鐘
游乐	遊樂
余责	餘責
炼句	鍊句
金马仑道	金馬崙道
涂坤	涂坤
裹著稱	裹著稱
钟陈列	鐘陳列
颈	頸
犊	犢
轻于	輕於
皓发	皓髮
笔试	筆試
努力著作	努力著作
𫚉	魟
𫚈	鱮
𫚕	鰤
𫚔	鮰
电杆	電杆
并科	併科
采矿	採礦
𫚒	鮄
觚棱	觚稜
采石	採石
𫚙	鯆
哀挽	哀輓
国历经	國歷經
一出子	一齣子
义仆	義僕
试药	試藥
脏词	髒詞
四舍五入	四捨五入
涵著名	涵著名
低洼	低洼
发髻	髮髻
采石之役	采石之役
杰特	杰特
脏话	髒話
导游	導遊
机械表	機械錶
陪著者	陪著者
受著名	受著名
垦复	墾複
敢情欲	敢情欲
管著稱	管著稱
圍著	圍着
涵著	涵着
因著	因着
下课钟	下課鐘
干雷	乾雷
扎根	紮根
药典	藥典
偎干	偎乾
心系母	心繫母
周游世界	週遊世界
覆命	覆命
懒	懶
于涛	于濤
强干	強幹
著落	着落
回转	迴轉
䴙	鷿
崃	崍
衷于	衷於
3年	3年
缓征	緩徵
干稿	乾稿
暗著錄	暗著錄
纏著	纏着
辩斗	辯鬥
面包含	面包含
烟	煙
定著作	定著作
配制饲料	配制飼料
用不著	用不着
夏历史	夏歷史
崭	嶄
饼干	餅乾
个中讯息	箇中訊息
药水	藥水
出租车	的士
于爾根	于爾根
借著錄	借著錄
梳著作	梳著作
𡒄	壈
燎发	燎髮
忙里偷闲	忙裡偷閒
豫著錄	豫著錄
铲出	剷出
王侯后	王侯后
心系远	心繫遠
吾为之范我驰驱	吾爲之範我馳驅
丽	麗
占北	佔北
心系近	心繫近
征聘	徵聘
遠著書	遠著書
裝著名	裝著名
谁干的	誰幹的
干回付	乾回付
㔉	劚
嗫	囁
半只可	半只可
受著錄	受著錄
心系妻	心繫妻
沈海铁路	瀋海鐵路
系绳	繫繩
尽力	儘力
积极参与	積极參与
嗳	噯
流于	流於
卷筒	捲筒
月球历表	月球曆表
复对数	複對數
呆呆挣挣	呆呆掙掙
心系妇	心繫婦
鹰雕	鹰鵰
躺著錄	躺著錄
抹干	抹乾
秒钟	秒鐘
藏于	藏於
坑里	坑裡
皮里春秋	皮裡春秋
郁郁葱葱	鬱鬱蔥蔥
配水干管	配水幹管
來著名	來著名
本著稱	本著稱
汹	洶
明天	明天
澹荡	澹蕩
？克制	？剋制
磨制	磨製
遠著名	遠著名
优于	優於
出乖露丑	出乖露醜
彩楼	綵樓
这只	這隻
丰度	丰度
吹著述	吹著述
鳔	鰾
狄安娜	戴安娜
着色软体	著色軟體
占有五不验	占有五不驗
丁丑	丁丑
大只在	大只在
巡回	巡迴
系念	繫念
杠杆	槓桿
疑著	疑着
拼著錄	拼著錄
𩨀	騔
系心	繫心
不好干预	不好干預
其二只	其二只
询于	詢於
亞塞拜然	阿塞拜疆
恶直丑正	惡直醜正
湘绣	湘繡
仆固怀恩	僕固懷恩
钟在寺里	鐘在寺裡
悬臂梁	懸臂樑
钟形	鐘形
复分析	複分析
余地	餘地
丑八怪	醜八怪
卞庄	卞莊
牛肉面	牛肉麵
應著書	應著書
环游	環遊
公車	巴士
領著名	領著名
遗迹	遺迹
撼著名	撼著名
舱	艙
舰	艦
采样	採樣
舻	艫
项庄	項莊
埋头寻表	埋頭尋錶
舣	艤
颙	顒
对表明	對表明
于姓	于姓
回风	迴風
理个发	理個髮
５天后	５天後
辟筑	闢築
郁郁青青	郁郁青青
马拉特·萨芬	沙芬
髭著者	髭著者
峰回	峰迴
酒肴	酒肴
瞪著名	瞪著名
味著書	味著書
弱于	弱於
丸药	丸藥
醜著述	醜著述
臨著	臨着
喂驴	餵驢
两余	兩餘
敞著作	敞著作
寸发千金	寸髮千金
蒙懂	懞懂
閉著名	閉著名
展著稱	展著稱
福著錄	福著錄
表行	錶行
浮著名	浮著名
呆子	獃子
埔裏社撫墾局	埔裏社撫墾局
范本	範本
村里長	村里長
卤面	滷麵
余映	餘映
成于思	成於思
超级杯	超級盃
发结	髮結
某只	某隻
九周后	九周後
敞著錄	敞著錄
響著稱	響著稱
斗而铸锥	鬥而鑄錐
李连杰	李連杰
于谦	于謙
記著作	記著作
大目干连	大目乾連
趕著錄	趕著錄
制著稱	制著稱
心系新	心繫新
三个	三個
余明	餘明
沿著作	沿著作
行事历	行事曆
殿钟自鸣	殿鐘自鳴
浮荡	浮蕩
跑著錄	跑著錄
小型钟表	小型鐘錶
乾象曆	乾象曆
只身上無	只身上無
黎吉云	黎吉雲
游目骋怀	遊目騁懷
划出	划出
圣后	聖后
特制住	特制住
点半钟	點半鐘
椟	櫝
椠	槧
人参赞	人參贊
椤	欏
钝	鈍
對著稱	對著稱
椁	槨
活著錄	活著錄
费占	費佔
郓	鄆
流著書	流著書
吊杆	吊杆
颐	頤
弄干	弄乾
心系泰	心繫泰
电波钟	電波鐘
含著述	含著述
近角聪信	近角聰信
篮	籃
通历	通曆
斥著作	斥著作
衣索匹亞	埃塞俄比亞
于震環	于震環
呗赞	唄讚
已占算	已占算
争奇斗艳	爭奇鬥豔
分布於	分佈於
浪琴表	浪琴錶
篱	籬
余〇	餘〇
编采	編採
干嚎	乾嚎
恒	恆
药量	藥量
抬著稱	抬著稱
恋	戀
郐	鄶
准直	準直
追著者	追著者
麗著述	麗著述
于默奥	于默奧
恺	愷
恻	惻
殺著者	殺著者
恹	懨
一出刊	一出刊
溢著稱	溢著稱
恼	惱
飞扎	飛紮
恳	懇
恶	惡
西西里	西西里
呆根	獃根
回阳荡气	回陽蕩氣
冀著作	冀著作
鹄	鵠
椭	橢
小型钟	小型鐘
狃于	狃於
西周钟	西周鐘
参与者	參與者
梁上君子	梁上君子
咸猪肉	鹹豬肉
托过	託過
标标致致	標標致致
锤子	鎚子
绣起	繡起
鹌	鵪
鸡腿面	雞腿麵
增辟	增闢
不丑	不醜
面条目	面條目
住著書	住著書
固定制	固定制
斗茶	鬥茶
注生娘娘	註生娘娘
瞪著稱	瞪著稱
干济	幹濟
一吊钱	一吊錢
炒面	炒麵
哭脏	哭髒
涵著述	涵著述
考著名	考著名
寝	寢
开药	開藥
借寇兵	藉寇兵
酥松	酥鬆
萬那杜	瓦努阿圖
考著	考着
奸淫掳掠	奸淫擄掠
撷	擷
对	對
寿	壽
导	導
别致	別緻
匪干	匪幹
撵	攆
跪著作	跪著作
丑小鸭	醜小鴨
醜著書	醜著書
趕著名	趕著名
撺	攛
于學忠	于學忠
参阅	參閱
郁郁寡欢	鬱鬱寡歡
斗幌子	鬥幌子
撸	擼
颜范	顏範
被复	被複
磬钟	磬鐘
鹙	鶖
陋著書	陋著書
贤后	賢后
台球	檯球
并为一体	併為一體
岖	嶇
岗	崗
盘里	盤裡
占不足	佔不足
心系健	心繫健
于五	於五
游程	遊程
岘	峴
岙	嶴
岚	嵐
岛	島
钟表速	鐘錶速
岁	歲
赶面棍	趕麵棍
朝著稱	朝著稱
白粉面	白粉麵
九出刊	九出刊
鹠	鶹
６年	６年
岽	崬
岿	巋
晕船药	暈船藥
隐于	隱於
黄历史	黃歷史
抑制剂	抑制劑
岭	嶺
发卷	髮捲
风后，	風後，
卷舌	捲舌
心系世	心繫世
赞美	讚美
心系东	心繫東
荡寇	蕩寇
發表	發表
捉奸徒	捉奸徒
鹨	鷚
動著者	動著者
心系万	心繫萬
斗不过	鬥不過
吐哺捉发	吐哺捉髮
心系一	心繫一
凭吊	憑弔
響著作	響著作
夸克	夸克
牽著作	牽著作
篑	簣
后街	后街
瞧着表	瞧著錶
跟著稱	跟著稱
心系两	心繫兩
篓	簍
心系中	心繫中
丰标不凡	丰標不凡
鹰	鷹
事都干脆	事都干脆
采到	採到
采制	採制
复查	複查
鹲	鸏
面塑	麵塑
眼干	眼乾
乱哄	亂鬨
聞不著	闻不着
綁著名	綁著名
犯不著者	犯不著者
十出口	十出口
傲霜斗雪	傲霜鬥雪
严于	嚴於
斗打	鬥打
學著者	學著者
浮著錄	浮著錄
循著作	循著作
疑著作	疑著作
属托	屬託
辦著述	辦著述
占有欲	佔有慾
涂善妮	涂善妮
准点	準點
一出祁山	一出祁山
颡	顙
困著名	困著名
流风余俗	流風餘俗
甲后路	甲后路
丝瓜布	絲瓜布
俄占	俄佔
映著稱	映著稱
拈须	拈鬚
钟纽	鐘紐
采树种	採樹種
包谷	包穀
王余鱼	王餘魚
于劣	於劣
业	業
事有斗巧	事有鬥巧
寇准	寇準
不准没	不准沒
于濤	于濤
騙著	騙着
陨	隕
干薪	乾薪
向应	嚮應
僮仆	僮僕
皆准	皆準
渠冲	渠衝
晚于	晚於
陋著述	陋著述
家具	傢具
怒发冲冠	怒髮衝冠
行凶前	行兇前
不好干預	不好干預
寇仇	寇讎
急著作	急著作
埔里社抚垦局	埔裏社撫墾局
假托	假託
后北街	后北街
喜欢表	喜歡錶
田庄	田莊
金表示	金表示
粪秽蔑面	糞穢衊面
重制	重製
占西	佔西
炼	煉
炽	熾
点	點
炀	煬
占美	佔美
炉	爐
炖	燉
布雷。	佈雷。
干細胞	幹細胞
炜	煒
炝	熗
余韵	餘韻
狄志杰	狄志杰
怀钟	懷鐘
穷发	窮髮
俭朴	儉樸
金装玉里	金裝玉裡
划进去	划進去
挨著稱	挨著稱
堙淀	堙澱
向著名	向著名
要自制	要自制
尊后	尊后
短于	短於
银朱	銀硃
布吉納法索	布基納法索
编码表	編碼表
鉤	鈎
干当	幹當
余音绕梁	餘音繞梁
平泉庄	平泉莊
冲倒	衝倒
紮著作	紮著作
别强	彆強
克星	剋星
折扇	摺扇
干片	乾片
铺	鋪
唱著述	唱著述
酒药	酒藥
铹	鐒
饴	飴
載著作	載著作
煨干	煨乾
饶	饒
饩	餼
心系夫	心繫夫
屯里	屯裡
于默奧	于默奧
过于	過於
永历史	永歷史
心系大	心繫大
饪	飪
咨询	諮詢
于少保	于少保
答覆	答覆
余暇	餘暇
干员	幹員
日心历表	日心曆表
張三丰	張三丰
求著述	求著述
只占卜	只占卜
沉著	沉着
制鞋	製鞋
恸	慟
虎斗	虎鬥
这只会	這只會
人如风后入江云	人如風後入江雲
顺风后	順風後
庄员	莊員
色欲	色慾
不锈钢	不鏽鋼
六天后	六天後
恽	惲
學著錄	學著錄
深渊里	深淵裡
摧坚获丑	摧堅獲醜
钟琴	鐘琴
那只需	那只需
身著作	身著作
老于	老於
征效	徵效
药液	藥液
動著名	動著名
吊纸	弔紙
移祸于	移禍於
隨著	隨着
换只	換隻
糊里糊涂	糊裡糊塗
于好	於好
转向往	轉向往
换发	換髮
能自制	能自制
躺著述	躺著述
嗑药	嗑藥
万旗	万旗
英占	英佔
瘘	瘺
这只允	這只允
追著錄	追著錄
族里	族裡
躍著名	躍著名
啭	囀
铛	鐺
许愿起经	許愿起經
啮	嚙
谂	諗
啧	嘖
于美人	于美人
克制不了	剋制不了
啸	嘯
颠覆	顛覆
啴	嘽
想象	想像
木梁	木樑
于云鹤	于雲鶴
4只支援	4只支援
遨游	遨遊
2只支持	2只支持
豎著稱	豎著稱
台布景	台布景
占去	佔去
騎著名	騎著名
占二	佔二
只身上无	只身上無
占了	佔了
托病	託病
秦庄襄王	秦莊襄王
门帘	門帘
尔冬升	爾冬陞
歷史裡	歷史裏
瘪	癟
二出版	二出版
占五	佔五
瘫	癱
划船	划船
烫一次发	燙一次髮
揉著	揉着
藉著	藉着
庄主	莊主
举手表决	舉手表決
用得著	用得着
苧悴	薴悴
逆著作	逆著作
涼著作	涼著作
中庄子	中庄子
刻著作	刻著作
晒黑	晒黑
尸禄	尸祿
斗口	鬥口
挽詩	輓詩
傳位于四太子	傳位于四太子
铍	鈹
事迹	事迹
品汇	品彙
0只支援	0只支援
嫌好道丑	嫌好道醜
大只	大隻
吊词	弔詞
柜柳	柜柳
孙	孫
瘾	癮
范文同	范文同
榨干	榨乾
铀	鈾
为准	為準
竞斗	競鬥
呆呆兽	呆呆獸
性著作	性著作
好斗蓬	好斗蓬
安于	安於
卷舖盖	捲舖蓋
白里透红	白裡透紅
吊诡	弔詭
复审	複審
芗	薌
暴晒	暴晒
寺钟	寺鐘
于她	於她
做著作	做著作
松口	鬆口
节	節
笑里藏刀	笑裡藏刀
芈	羋
天克地冲	天克地衝
晞发	晞髮
采莲	採蓮
采获	採獲
考征	考徵
俯冲	俯衝
屯扎	屯紮
注失	註失
飄著名	飄著名
斗艳	鬥豔
陪著述	陪著述
吃姜	吃薑
余角	餘角
较于	較於
繞著述	繞著述
騎著錄	騎著錄
瞅下表	瞅下錶
干个够	乾個夠
住著稱	住著稱
重折	重摺
關著書	關著書
葛摩	科摩羅
定著書	定著書
冬天里	冬天裡
钟下	鐘下
后天	後天
随于	隨於
心系京	心繫京
斗闷	鬥悶
只身後	只身後
心系人	心繫人
蜡月	蜡月
药箱	藥箱
叱咤My903	叱咤My903
聽著者	聽著者
这只不	這只不
别扭	彆扭
於姓	於姓
住著	住着
心系黄	心繫黃
结余	結餘
前言不答后语	前言不答後語
擋著稱	擋著稱
褒赞	褒讚
瞞著	瞞着
心系五	心繫五
蒙汜	濛汜
捷豹	積架
带征	帶徵
雾里	霧裡
叫著述	叫著述
涂	塗
回文	迴文
筑後	筑後
抱著錄	抱著錄
淡蒙蒙	淡濛濛
撼著書	撼著書
涞	淶
尸居余气	尸居餘氣
耕佣	耕傭
药费	藥費
自制你	自制你
鋪著錄	鋪著錄
怀表	懷錶
复杂	複雜
逦	邐
药贩	藥販
面包揽	面包攬
穑	穡
跪著述	跪著述
茶面	茶麵
坛子	罈子
干流	幹流
達著者	達著者
征结	徵結
亿周后	億周後
心系汶	心繫汶
并曰入淀	並曰入澱
求知欲	求知慾
穷	窮
占百	佔百
面包容	面包容
漂荡	漂蕩
委托	委託
南宫适	南宮适
主钟曲线	主鐘曲線
語著稱	語著稱
纪	紀
对准表	對準錶
公車上書	公車上書
附著名	附著名
仪范	儀範
心系江	心繫江
懔	懍
肉欲	肉慾
懑	懣
偷著稱	偷著稱
揉著名	揉著名
绿发	綠髮
对表达	對表達
辟土	闢土
于立成	于立成
造钟表	造鐘錶
药酒	藥酒
之余	之餘
只采	只採
大本钟敲	大本鐘敲
娲杆	媧杆
杰伦	杰倫
决斗	決鬥
身于	身於
范文程	范文程
虮蝨相吊	蟣蝨相弔
润	潤
辟地	闢地
退烧药	退燒藥
布雷艇	佈雷艇
发辫	髮辮
基准	基準
猫	貓
猬	蝟
无法克制	無法剋制
盐卤	鹽滷
对准	對準
坐如钟	坐如鐘
猡	玀
踏著	踏着
摊	攤
庄客	莊客
弹	彈
所占卜	所占卜
占缺	佔缺
一出生	一出生
喂乳	餵乳
抵御	抵禦
中型钟表面	中型鐘表面
猎	獵
瞩托	矚託
猃	獫
亮著作	亮著作
丑比	醜比
斗叶儿	鬥葉兒
猕	獼
彩球	綵球
窗台上	窗台上
井里	井裡
考著稱	考著稱
叫著	叫着
冲冠	衝冠
卤制	滷製
传位于四太子	傳位于四太子
话里有话	話裡有話
庄骚	莊騷
七余	七餘
弪	弳
选	選
文采郁郁	文采郁郁
剪其发	剪其髮
症候	癥候
呆想	獃想
多半只	多半只
威棱	威稜
无业游民	無業游民
騎著稱	騎著稱
叶叶琴	葉叶琴
肝郁	肝鬱
闹钟	鬧鐘
郁闭	鬱閉
哭著稱	哭著稱
郁闷	鬱悶
阵	陣
就克制	就剋制
管人吊脚儿事	管人弔腳兒事
信著錄	信著錄
袖里	袖裡
爽荡	爽蕩
赢余	贏餘
面码儿	麵碼兒
树干	樹榦
后豐	后豐
酝酿着	醞釀著
炼钢	鍊鋼
无梁楼盖	無樑樓蓋
我克制	我剋制
占Ｇ	佔Ｇ
占Ｆ	佔Ｆ
占Ｅ	佔Ｅ
尝	嘗
占Ｃ	佔Ｃ
占Ｂ	佔Ｂ
占Ａ	佔Ａ
双雕	雙鵰
占Ｏ	佔Ｏ
占Ｎ	佔Ｎ
占Ｍ	佔Ｍ
占Ｌ	佔Ｌ
占Ｋ	佔Ｋ
占Ｊ	佔Ｊ
占Ｉ	佔Ｉ
占Ｈ	佔Ｈ
占Ｗ	佔Ｗ
寻	尋
占Ｕ	佔Ｕ
占Ｔ	佔Ｔ
見著名	見著名
占Ｒ	佔Ｒ
占Ｑ	佔Ｑ
占Ｐ	佔Ｐ
将	將
沉著稱	沉著稱
占Ｚ	佔Ｚ
占Ｙ	佔Ｙ
占Ｘ	佔Ｘ
尽	盡
尸	屍
尴	尷
三出祁山	三出祁山
青山一发	青山一髮
占７	佔７
占６	佔６
占５	佔５
魔表	魔錶
占３	佔３
占２	佔２
占１	佔１
占０	佔０
綁著者	綁著者
尧	堯
只身上没	只身上沒
一干人	一干人
占９	佔９
占８	佔８
葫芦里卖甚么药	葫蘆裡賣甚麼藥
药头	藥頭
奋	奮
九龙表行	九龍表行
咸水	鹹水
都于	都於
有征战	有征戰
用著述	用著述
相于	相於
一只	一隻
詩云	詩云
词干	詞幹
受著書	受著書
有征戰	有征戰
准保	準保
划着走	划著走
于野	於野
屡顾尔仆	屢顧爾僕
佣人	傭人
看钟	看鐘
斗殴	鬥毆
制作	製作
埋头寻钟	埋頭尋鐘
槟	檳
捆著述	捆著述
出儿	齣兒
腊之以为饵	腊之以為餌
占分	佔分
占哺乳	佔哺乳
盐余	鹽餘
動著作	動著作
哗	嘩
哕	噦
哔	嗶
哓	嘵
哒	噠
药到病除	藥到病除
解雇	解僱
哟	喲
哝	噥
哜	嚌
試著	試着
哙	噲
占到	佔到
每只	每隻
西谷米	西谷米
响	響
强占	強佔
余九	餘九
丰采	丰采
识	識
順著書	順著書
评	評
诅	詛
映著	映着
诃	訶
纯朴	純樸
证	證
诎	詘
诏	詔
辟田	闢田
词	詞
诊	診
翻涌	翻湧
诈	詐
诉	訴
𩧰	䮝
愛著者	愛著者
诔	誄
试	試
遠著	遠着
诓	誆
诐	詖
译	譯
诞	誕
诟	詬
𩧺	駶
话	話
诚	誠
诛	誅
诘	詰
𩧿	䮠
详	詳
诧	詫
诤	諍
该	該
询	詢
诣	詣
诠	詮
诡	詭
诮	誚
误	誤
诬	誣
语	語
背向着	背向著
诫	誡
诨	諢
诩	詡
诶	誒
请	請
说	說
口干冒	口干冒
诲	誨
诳	誑
诰	誥
诱	誘
课	課
罩著者	罩著者
诼	諑
诽	誹
诺	諾
读	讀
诸	諸
甜著述	甜著述
心系林	心繫林
綁著書	綁著書
大明历史	大明歷史
奥	奧
尸臣	尸臣
谢绝参观	謝絕參觀
柜台	櫃檯
迷药	迷藥
冲来	衝來
赤霉素	赤霉素
每每只	每每只
涂长望	涂長望
征圣	徵聖
钟乳石	鐘乳石
披发	披髮
受著稱	受著稱
对准钟表	對準鐘錶
豎著書	豎著書
临潼斗宝	臨潼鬥寶
阁	閣
交托	交託
郊游	郊遊
夯干	夯幹
茕	煢
茔	塋
1天后	1天後
郁血	鬱血
茏	蘢
茎	莖
肮	骯
力拼	力拚
于冠华	于冠華
蹭棱子	蹭稜子
放荡	放蕩
于孔兼	于孔兼
大伙	大夥
晒伤	晒傷
发引千钧	髮引千鈞
中型钟表	中型鐘錶
秒表	秒錶
采茶	採茶
扎起	紮起
官庄	官莊
字里行间	字裡行間
聽得著	聽得着
肤	膚
茧	繭
遇著稱	遇著稱
沿著者	沿著者
千扎	千紮
！克制	！剋制
丝恩发怨	絲恩髮怨
圈占	圈佔
党进	党進
斗心眼	鬥心眼
性征	性徵
佣金收益	佣金收益
面店	麵店
令人发指	令人髮指
烫完发	燙完髮
六年	六年
竹制	竹製
涛	濤
沈吉线	瀋吉線
伊里布	伊里布
系怀	繫懷
悬钟	懸鐘
羡余	羨餘
于丹	于丹
趕著稱	趕著稱
干料	乾料
灵药	靈藥
管著錄	管著錄
占法	佔法
数与虏确	數與虜确
尽尽	儘儘
呆呆	獃獃
紧	緊
年代里	年代裡
所占	所佔
韩国制	韓國製
干茨腊	乾茨臘
死里求生	死裡求生
梦游	夢遊
有著述	有著述
載著稱	載著稱
有征伐	有征伐
抱著稱	抱著稱
1只支援	1只支援
高清愿	高清愿
调准	調準
卢棱伽	盧稜伽
于占元	于占元
對著	對着
防晒	防晒
戴著述	戴著述
閑著錄	閑著錄
横	橫
支杆	支杆
尸羅精舍	尸羅精舍
著法	着法
循著書	循著書
农民历	農民曆
游星	遊星
朱红色	硃紅色
樱	櫻
复目	複目
岂	豈
竞	競
吊带	弔帶
迈克尔·欧文	米高奧雲
插于	插於
信著作	信著作
郁郁不平	鬱鬱不平
戲裡	戲裏
干支支	乾支支
乌发	烏髮
潜意识里	潛意識裡
皇后	皇后
跑著者	跑著者
叽	嘰
家具木工科	家具木工科
心著作	心著作
臻于	臻於
颉	頡
颊	頰
颋	頲
颌	頜
颍	潁
颎	熲
颏	頦
颀	頎
荡然	蕩然
四舍六入	四捨六入
颃	頏
预	預
颅	顱
领	領
颇	頗
题	題
于世	於世
颚	顎
艳	艷
颜	顏
额	額
颞	顳
颟	顢
于终	於終
频	頻
颒	頮
颓	頹
颔	頷
颕	頴
颖	穎
颗	顆
采納	採納
春香斗学	春香鬥學
吊钟	吊鐘
駕著名	駕著名
颠	顛
艷后	艷后
颢	顥
浩荡	浩蕩
颥	顬
颦	顰
颧	顴
后发座	后髮座
慑	懾
獨著稱	獨著稱
一发千钧	一髮千鈞
点钟	點鐘
占下	佔下
占一	佔一
八天后	八天後
采石之戰	采石之戰
蛮干	蠻幹
酿	釀
解药	解藥
占东	佔東
南筑	南筑
棱子	稜子
雅著	雅着
亮丑	亮醜
宣泄	宣洩
占个	佔個
钟匠	鐘匠
占中	佔中
占两	佔兩
酾	釃
首当其冲	首當其衝
口干犯	口干犯
占为	佔為
占主	佔主
扛著稱	扛著稱
含著名	含著名
豫著述	豫著述
秃发	禿髮
丑女	醜女
2天后	2天後
流著者	流著者
仗著者	仗著者
配药	配藥
嫔	嬪
嫒	嬡
阑	闌
余光生	余光生
零多只	零多隻
干湿	乾濕
复音	複音
防范	防範
自制一下	自制一下
手里	手裡
嫱	嬙
自制的能	自制的能
吊祭	弔祭
四出刊	四出刊
那只用	那只用
干面	乾麵
咸派	鹹派
提摩太后书	提摩太後書
园游会	園遊會
参观团	參觀團
发脚	髮腳
凶嫌	兇嫌
心系女	心繫女
竖起脊梁	豎起脊梁
传于	傳於
兽	獸
疏松	疏鬆
心系舞	心繫舞
不克自制	不克自制
晕车药	暈車藥
9只	9隻
永历	永曆
捉发	捉髮
網際網路	互聯網
厢	廂
黄发	黃髮
厦	廈
厨	廚
厩	廄
樂著	樂着
电子表格	電子表格
伤	傷
余五	餘五
狱里	獄裡
繞著	繞着
发呆	發獃
自制我	自制我
回路	迴路
县	縣
著祂	着祂
厂	廠
厅	廳
历	歷
余事	餘事
厉	厲
只采声	只采聲
压	壓
厌	厭
厍	厙
厐	龎
阿斯图里亚斯	阿斯圖里亞斯
厕	廁
丑徒	醜徒
干暖	乾暖
喽	嘍
撞球台	撞球檯
余二	餘二
姜末	薑末
土霉素	土霉素
干劲冲天	幹勁沖天
显示钟表	顯示鐘錶
畅游	暢遊
浅淀	淺澱
大笨钟敲	大笨鐘敲
盾著稱	盾著稱
发签	發籤
學著	學着
雪裡紅	雪裏紅
别拗	彆拗
演著錄	演著錄
著我	着我
記著	記着
采证	採證
埚	堝
余波荡漾	餘波盪漾
埙	塤
世界裡	世界裏
惊钟	驚鐘
好丑	好醜
賸余	賸餘
复发	複發
握发	握髮
大只会	大只會
藏著稱	藏著稱
１只	１隻
干草	乾草
配著書	配著書
漫著名	漫著名
干燥	乾燥
复句	複句
面坊	麵坊
俨	儼
俩	倆
复叶	複葉
大只有	大只有
赞羡	讚羨
沉郁	沉鬱
弄脏	弄髒
烘干	烘乾
国于	國於
慣著名	慣著名
尽速	儘速
味著	味着
潤著錄	潤著錄
紧追不舍	緊追不捨
被覆着	被覆著
衛	衞
有只容	有只容
俣	俁
见棱见角	見稜見角
甜著	甜着
衔	銜
祸于	禍於
钱庄	錢莊
衬	襯
衮	袞
谷子	穀子
占高枝儿	佔高枝兒
补	補
折向往	折向往
跳著名	跳著名
尸位素餐	尸位素餐
５周后	５周後
候著書	候著書
夾著	夾着
准线	準線
复检	複檢
向往	嚮往
桌几	桌几
上梁山	上梁山
荞麦面	蕎麥麵
钟表的历史	鐘錶的歷史
毒药	毒藥
追著作	追著作
赞赏	讚賞
變著述	變著述
挽曲	輓曲
丑陋	醜陋
征人	徵人
创制	創製
猜著名	猜著名
尋著稱	尋著稱
现	現
玱	瑲
折叠	摺疊
玺	璽
靠著錄	靠著錄
葡占	葡佔
醯壺	醯壺
順著稱	順著稱
艳后	艷后
占线	佔線
丑死	醜死
春药	春藥
醯壶	醯壺
环	環
閑著述	閑著述
玑	璣
周历	周曆
拼舍	拚捨
玚	瑒
玛	瑪
余零	餘零
𪎈	䴬
𪎉	麲
𪎊	麨
𪎋	䴴
一周后	一周後
个中资讯	箇中資訊
5只支持	5只支持
膨松	膨鬆
貞著者	貞著者
绣房	繡房
干干	乾乾
事情干脆	事情干脆
绣户	繡戶
二年	二年
于志寧	于志寧
圈梁	圈樑
发饰	髮飾
松松	鬆鬆
水准	水準
击钟	擊鐘
悠著錄	悠著錄
打卡钟	打卡鐘
翻云覆雨	翻雲覆雨
蜕	蛻
新井里美	新井里美
脏乱	髒亂
寿面	壽麵
沉著作	沉著作
丑言	醜言
吊取	弔取
下注解	下注解
酒曲	酒麴
穆罕默德历	穆罕默德曆
動著錄	動著錄
提子干	提子乾
５余	５餘
化学家	化學家
流著名	流著名
心里面	心裏面
背著作	背著作
家丑	家醜
始于	始於
骨灰坛	骨灰罈
借著述	借著述
心系昌	心繫昌
䍀	繿
䍁	繸
这钟	這鐘
络腮胡	絡腮鬍
4余	4餘
記著稱	記著稱
冬山庄	冬山庄
喜欢钟表	喜歡鐘錶
克期	剋期
覆着	覆著
于贈	于贈
殓	殮
殒	殞
行著述	行著述
殚	殫
殇	殤
心系日	心繫日
裁制	裁製
殁	歿
残	殘
现于	現於
殴	毆
1只	1隻
蛊	蠱
殡	殯
載著	載着
采选	採選
发根	髮根
制件	製件
罚	罰
得著書	得著書
手表示	手表示
据云	據云
醋坛	醋罈
夸特	夸特
蘸著作	蘸著作
范字	範字
拉著	拉着
游骑兵	遊騎兵
了望	瞭望
数罪并罚	數罪併罰
须鲨	鬚鯊
叫著名	叫著名
北回铁路	北迴鐵路
防御	防禦
干梅	乾梅
起哄	起鬨
余力為	余力為
捶炼	捶鍊
伟	偉
衣著述	衣著述
不准谁	不准誰
店里	店裡
夾著述	夾著述
呙	咼
员	員
呛	嗆
看着钟表	看著鐘錶
奸杀	姦殺
占劣	佔劣
呐	吶
呓	囈
多只用	多只用
呕	嘔
系列裡	系列裏
呖	嚦
高著	高着
卷图	捲圖
晒谷	曬穀
单打独斗	單打獨鬥
这只能	這只能
抚	撫
筑紫	筑紫
凶枪	兇槍
遇著作	遇著作
神游	神遊
岳岳	嶽嶽
用著	用着
努力著錄	努力著錄
南屏晚钟	南屏晚鐘
科范	科範
走著述	走著述
争妍斗艳	爭妍鬥豔
台子女	台子女
桌历	桌曆
多么	多麼
订	訂
于阗	于闐
開著名	開著名
惯	慣
丑声	醜聲
折裙	摺裙
建于	建於
了克制	了剋制
更签	更籤
发庄	發莊
原钟	原鐘
急著	急着
來著錄	來著錄
殴斗	毆鬥
婳	嫿
金发	金髮
婴	嬰
婶	嬸
立于	立於
備著者	備著者
舍堕	捨墮
潭里	潭裡
呆痴	獃痴
贻范	貽範
修胡刀	修鬍刀
迥然回异	迥然迴異
急著錄	急著錄
布什	布殊
6只支援	6只支援
莱	萊
莳	蒔
莲	蓮
莴	萵
素发	素髮
莶	薟
莹	瑩
莸	蕕
心系震	心繫震
莼	蒓
流露著	流露着
莅	蒞
８只	８隻
肤发	膚髮
三扎	三紮
原子钟	原子鐘
抓奸	抓姦
苦著述	苦著述
0只支持	0只支持
3余	3餘
陋著錄	陋著錄
吹发	吹髮
游踪	遊蹤
车	車
丰儀	丰儀
余子明	余子明
宫里	宮裡
对表现	對表現
获匪其丑	獲匪其醜
著什麼急	着什麼急
脏字	髒字
丽于	麗於
附著作	附著作
慣著	慣着
游逛	遊逛
性著錄	性著錄
鬥著名	鬥著名
宫	宮
铜制	銅製
面厂	麵廠
燒著述	燒著述
别日南鸿才北去	別日南鴻纔北去
骚	騷
那只可	那只可
这只容	這只容
當著作	當著作
家具备	家具備
獲著名	獲著名
蘸著錄	蘸著錄
棱等登	稜等登
火签	火籤
占头筹	佔頭籌
山洞裡	山洞裏
𨰿	釳
附著稱	附著稱
家庄	家莊
于子千	于子千
住著錄	住著錄
准新郎	準新郎
關著者	關著者
有准	有準
括发	括髮
挑著稱	挑著稱
閉著	閉着
丰姿	丰姿
讬	託
多余	多餘
惴栗	惴慄
等于	等於
上签字	上簽字
定于	定於
干菜	乾菜
药舖	藥舖
千只足够	千只足夠
困著書	困著書
须须	鬚鬚
棱棱	稜稜
复印	複印
索馬里	索馬里
擦药	擦藥
伴著者	伴著者
箓	籙
占D	佔D
半只够	半只夠
着儿	著兒
编制法	編制法
殺著作	殺著作
坐著錄	坐著錄
畴	疇
聽著書	聽著書
多只在	多只在
斗暴	鬥暴
荡女	蕩女
朱砂	硃砂
心系浙	心繫浙
畅	暢
骟	騸
占E	佔E
扛著書	扛著書
棱线	稜線
回历	回曆
回光返照	迴光返照
九只	九隻
拨	撥
呆串了皮	獃串了皮
电线杆	電線杆
庙里	廟裡
拢	攏
拣	揀
拥	擁
拦	攔
借资	藉資
弥漫	瀰漫
干唱	乾唱
牵一发	牽一髮
汇刊	彙刊
痒痒	痒痒
钟被	鐘被
三出刊	三出刊
仆僮	僕僮
喷洒	噴洒
于色	於色
空著述	空著述
拟	擬
罵著名	罵著名
如饥似渴	如饑似渴
心余	心餘
于正升	于正昇
爷	爺
那只	那隻
脊梁背	脊梁背
姜老辣	薑老辣
黄诗杰	黃詩杰
零天后	零天後
铁锤	鐵鎚
手表态	手表態
十扎	十紮
走著名	走著名
戀著者	戀著者
梁上	樑上
宽余	寬餘
划一桨	划一槳
中仑	中崙
兀术	兀朮
占过	佔過
欲海难填	欲海難填
杰威尔音乐	杰威爾音樂
悠著	悠着
候著稱	候著稱
蓄须	蓄鬚
古书云	古書云
干巴	乾巴
千余	千餘
郧	鄖
郦	酈
頂著名	頂著名
郸	鄲
𫂈	䉬
别庄	別莊
补于	補於
泞	濘
谷场	穀場
郏	郟
庄稼人	庄稼人
扛著	扛着
泪	淚
腐干	腐乾
游园	遊園
鉤心鬥角	鈎心鬥角
松柔	鬆柔
泶	澩
泷	瀧
泸	瀘
睡著	睡着
泺	濼
泻	瀉
泼	潑
泽	澤
思如泉涌	思如泉湧
獲著稱	獲著稱
丰茸	丰茸
锤头	鎚頭
占山	佔山
犹如钟表	猶如鐘錶
市里	市裡
心系生	心繫生
一吊	一弔
見著書	見著書
孤著作	孤著作
干村沙	乾村沙
加药	加藥
占屋	佔屋
𩐀	䪗
揽	攬
侥幸	僥倖
蒙直	懞直
凶殘	兇殘
匮	匱
心系困	心繫困
发乳	髮乳
心系国	心繫國
匦	匭
区	區
医	醫
凶残	兇殘
骉	驫
历命	曆命
箫	簫
箨	籜
蒙昧无知	矇昧無知
换药	換藥
凶殺	兇殺
船只能	船只能
不干你	不干你
明范	明範
匀	勻
码表	碼錶
心系四	心繫四
纥	紇
餍	饜
旧药	舊藥
赞词	讚詞
拿著稱	拿著稱
复线	複線
武丑	武丑
理一次发	理一次髮
冲出	衝出
一干二净	一乾二淨
累臣	纍臣
頂多	頂多
凤梨干	鳳梨乾
變著書	變著書
只占算	只占算
亮著名	亮著名
見著錄	見著錄
干群关系	幹群關係
背著錄	背著錄
限制	限制
周庄王	周莊王
美著作	美著作
耀著書	耀著書
冲头阵	衝頭陣
调表	調錶
通心面	通心麵
盛赞	盛讚
满拼自尽	滿拚自盡
尽其所有	儘其所有
照著名	照著名
着录规则	著錄規則
药婆	藥婆
頂著述	頂著述
制著	制着
領域裡	領域裏
跳梁小丑	跳樑小丑
赵威后	趙威后
幹著	幹着
掖著	掖着
大衍历史	大衍歷史
樗里子	樗里子
望著書	望著書
留著稱	留著稱
药渣	藥渣
只手遮天	隻手遮天
跪著書	跪著書
回荡	回蕩
万年	萬年
寶曆	寶曆
下梁	下樑
钹	鈸
刮去	颳去
致密	緻密
屋里	屋裡
钻	鑽
裆	襠
装	裝
裈	褌
凶险	兇險
斗士	鬥士
线	線
盏	盞
瞳蒙	瞳矇
钿	鈿
裢	褳
裣	襝
裤	褲
裥	襇
落著	落着
散荡	散蕩
药片	藥片
晃著作	晃著作
脏心	髒心
制剂	製劑
采得	採得
征吏	徵吏
不干扰	不干擾
福著名	福著名
征实	徵實
丑媳妇	醜媳婦
于樹潔	于樹潔
钨	鎢
走著錄	走著錄
干吗	幹嗎
吹胡	吹鬍
药物	藥物
雪里	雪裡
药	葯
自制能力	自制能力
征启	徵啟
钫	鈁
笋干	筍乾
普冬冬	普鼕鼕
孤著稱	孤著稱
书呆子	書獃子
便药	便藥
漓湘	灕湘
照著錄	照著錄
耢	耮
稽征	稽徵
寫著稱	寫著稱
耻	恥
據著者	據著者
耸	聳
美仑	美崙
于廣洲	于廣洲
凭准	憑準
2余	2餘
复阅	複閱
历室	曆室
雇主	僱主
盧安達	盧旺達
转托	轉託
钦	欽
盖	蓋
托管国	托管國
壓著名	壓著名
汇辑	彙輯
合历	合曆
信著	信着
于密	於密
學著述	學著述
性著書	性著書
涼著稱	涼著稱
轉著述	轉著述
文丑	文丑
汇纂	彙纂
連著者	連著者
于寘	于寘
彩衣	綵衣
跪著	跪着
配制	配製
努著書	努著書
钐	釤
耀著錄	耀著錄
晨钟	晨鐘
空中布雷	空中佈雷
行事历史	行事歷史
干霍乱	乾霍亂
可以克制	可以剋制
溢著名	溢著名
丑妇	醜婦
占毕	佔畢
占比	佔比
白皮松	白皮松
藝著作	藝著作
扎下	紮下
扎上	紮上
數著名	數著名
寫著名	寫著名
并不准	並不准
针	針
海干	海乾
纏著者	纏著者
钉	釘
心系德	心繫德
嚷著書	嚷著書
尽可能	儘可能
光著作	光著作
庄田	莊田
䦃	鐯
雇工	僱工
摭采	摭採
于越	于越
饥饱	饑飽
試著者	試著者
休征	休徵
制造	製造
黄	黃
绣的	繡的
少占	少佔
黉	黌
迷蒙	迷濛
洒淅	洒淅
十个	十個
字码表	字碼表
郁卒	鬱卒
郁南	鬱南
正官庄	正官庄
占耕	佔耕
府干卿	府干卿
致于	致於
与克制	與剋制
黡	黶
的克制	的剋制
黪	黲
黩	黷
做著稱	做著稱
留著名	留著名
沈河	瀋河
面饼	麵餅
面饺	麵餃
舞后	舞后
愛著錄	愛著錄
欧	歐
干个	幹個
占七	佔七
壓著錄	壓著錄
石英钟表	石英鐘錶
領著錄	領著錄
痫	癇
欲望	慾望
臨著錄	臨著錄
卤菜	滷菜
系于一发	繫於一髮
求签	求籤
系数	係數
吃得著	吃得着
痉	痙
痈	癰
痖	瘂
著腳	着腳
隔著述	隔著述
燕巢于幕	燕巢於幕
福著述	福著述
馔	饌
馕	饢
扰	擾
小只会	小只會
馐	饈
馑	饉
馒	饅
鉴	鑒
于振	于振
馄	餛
雪里红	雪裡紅
馆	館
馇	餷
馀	餘
执	執
馂	餕
馃	餜
扪	捫
池里	池裡
馎	餺
扩	擴
馈	饋
馉	餶
扬	揚
馋	饞
扑	撲
帘子	帘子
7余	7餘
著她	着她
低著述	低著述
豎著述	豎著述
跳荡	跳蕩
抱著作	抱著作
卤鸡	滷雞
解痛药	解痛藥
雕心雁爪	鵰心雁爪
课征	課徵
占优	佔優
征象	徵象
仆少	僕少
雕翎	鵰翎
想克制	想剋制
故事裡	故事裏
新历	新曆
农庄	農莊
戀著錄	戀著錄
擢发	擢髮
逆风后	逆風後
拎著稱	拎著稱
推情准理	推情準理
涌向	湧向
漕挽	漕輓
划到岸	划到岸
１天后	１天後
胜于	勝於
含著稱	含著稱
拔发	拔髮
4天后	4天後
发布	發佈
姗	姍
望著錄	望著錄
咬姜呷醋	咬薑呷醋
栖栖皇皇	栖栖皇皇
溲面	溲麵
上课钟	上課鐘
姹	奼
占a	佔a
’	』
‘	『
升官	陞官
药效	藥效
”	」
“	「
发带	髮帶
骨子里	骨子裡
打著作	打著作
嚷著錄	嚷著錄
托疾	託疾
汇集	彙集
作品裡	作品裏
南京钟表	南京鐘錶
烟斗丝	煙斗絲
心系茶	心繫茶
胡梢	鬍梢
夸赞	誇讚
复本	複本
万签插架	萬籤插架
四分历史	四分歷史
钟声	鐘聲
拉面罩	拉面罩
大只是	大只是
達著稱	達著稱
后安路	后安路
敞著者	敞著者
依依不舍	依依不捨
二出逃	二出逃
斗彩	鬥彩
好勇斗狠	好勇鬥狠
钟壁	鐘壁
拼却	拚卻
那只会	那只會
累瓦结绳	纍瓦結繩
寄托	寄託
占l	佔l
动	動
嗅著	嗅着
凶横	兇橫
任何表演	任何表演
务	務
劢	勱
散于	散於
势	勢
新庄	新莊
拉克施尔德钟	拉克施爾德鐘
干枯	乾枯
劲	勁
辦著稱	辦著稱
照著者	照著者
本著書	本著書
踩著	踩着
舰只	艦隻
干果	乾果
撄	攖
劝	勸
晃荡	晃蕩
引斗	引鬥
复评	複評
布雷的	佈雷的
肝脏	肝臟
病征	病徵
复词	複詞
后座	后座
复诊	複診
踌	躊
复试	複試
有只允	有只允
克薄	剋薄
0只	0隻
小只在	小只在
陈有后	陳有后
潤著作	潤著作
保障著作	保障著作
甜著書	甜著書
住著者	住著者
金表	金錶
周二	周二
踬	躓
取舍	取捨
饥民	饑民
數據機	調制解調器
周五	周五
复课	複課
吊民	弔民
系到	繫到
游学	遊學
方志	方誌
不负所托	不負所托
榴蓮	榴槤
影后	影后
棉制	棉製
准话	準話
搏斗	搏鬥
行著	行着
跪著錄	跪著錄
高著者	高著者
剔庄货	剔莊貨
面包扎	面包紮
蒙混	矇混
余声	餘聲
残肴	殘肴
包准	包準
卷毛	捲毛
历史里	歷史裡
低著名	低著名
苍郁	蒼鬱
挂帘	掛帘
大锤	大鎚
卷风	捲風
枕著	枕着
䲡	鰌
钟点	鐘點
屑于	屑於
荡涤	蕩滌
出动画	齣動畫
挂帅	挂帥
血拼	血拚
剧药	劇藥
６周后	６周後
额我略历	額我略曆
萤	螢
凶巴巴	兇巴巴
能干扰	能干擾
郁勃	鬱勃
貞著書	貞著書
复比	複比
杯干	杯乾
庄家	莊家
绣鞋	繡鞋
盘	盤
马表	馬錶
仗著作	仗著作
芍药	芍藥
游客	遊客
有只不	有只不
壓著者	壓著者
丑巴怪	醜巴怪
征咎	徵咎
郁纡	鬱紆
行著名	行著名
公历	公曆
豫著者	豫著者
钟体	鐘體
县志	縣誌
犸	獁
型范	型範
状	狀
犷	獷
干粉	乾粉
子云	子云
云云	云云
角落发	角落發
拼著者	拼著者
對著書	對著書
那卷	那捲
撼著錄	撼著錄
铁钟	鐵鐘
大只可	大只可
干粮	乾糧
宇宙志	宇宙誌
金表露	金表露
厘清	釐清
谷神	穀神
照著稱	照著稱
寮國	老撾
叶不二子	叶不二子
桅杆	桅杆
汉	漢
会上签订	會上簽訂
遥	遙
甜面酱	甜麵醬
辟建	闢建
汇	匯
二周后	二周後
８周后	８周後
困倦起来	困倦起來
刻多钟	刻多鐘
努著作	努著作
含著者	含著者
二天后	二天後
教范	教範
范文澜	范文瀾
集于	集於
源于	源於
𫄸	纁
鸬	鸕
生姜	生薑
抓斗	抓鬥
范文芳	范文芳
汤	湯
𫄨	絺
所占算	所占算
党项	党項
户	戶
抗药	抗藥
鸠	鳩
昂著作	昂著作
著迷	着迷
蘖	櫱
余烈	餘烈
非占不可	非佔不可
粜	糶
只身為	只身為
怒于	怒於
于谨	于謹
候著者	候著者
毗婆尸佛	毗婆尸佛
斗着	鬥著
膠著書	膠著書
于忠肃集	于忠肅集
猜著書	猜著書
丝绒布	絲絨布
监	監
齿发	齒髮
有著書	有著書
征迹	徵跡
历尾	曆尾
跪著者	跪著者
高著錄	高著錄
于双戈	于雙戈
家伙	傢伙
粪	糞
鸿	鴻
鹅	鵝
游方	遊方
鹇	鷳
用著錄	用著錄
簡筑翎	簡筑翎
鹀	鵐
鹃	鵑
鹂	鸝
鹍	鵾
皮裡陽秋	皮裏陽秋
鹏	鵬
鸽	鴿
鹉	鵡
檩	檁
鹋	鶓
鹊	鵲
鹕	鶘
挑斗	挑鬥
鹗	鶚
鹖	鶡
鹑	鶉
鹐	鵮
鹓	鵷
鹒	鶊
鹝	鷊
鹜	鶩
鹟	鶲
鹞	鷂
连采	連採
鹘	鶻
鹛	鶥
鹚	鶿
鹥	鷖
鹤	鶴
鹧	鷓
鹦	鸚
鹡	鶺
心系天	心繫天
鹣	鶼
鹢	鷁
鹭	鷺
鹬	鷸
鹯	鸇
粉拳绣腿	粉拳繡腿
沈水	瀋水
余音	餘音
鹫	鷲
鹪	鷦
樂著名	樂著名
撑	撐
鹱	鸌
拖著者	拖著者
鹳	鸛
浮著者	浮著者
田谷	田穀
鹾	鹺
據著錄	據著錄
小只是	小只是
东岳	東嶽
遮丑	遮醜
斗牙斗齿	鬥牙鬥齒
精致	精緻
托词	託詞
連著名	連著名
高干扰	高干擾
栏杆	欄杆
打著錄	打著錄
蒙胧	朦朧
蒙汗药	蒙汗藥
遇著	遇着
爭著者	爭著者
必须	必須
醯鸡	醯雞
壓著稱	壓著稱
后庄	後庄
打并	打併
胃药	胃藥
冷面	冷麵
于貝爾	于貝爾
观采	觀採
窒欲	窒慾
９只	９隻
藝著	藝着
刹	剎
图鉴	圖鑑
请参阅	請參閱
发菜	髮菜
参与人员	參與人員
膠著名	膠著名
凹洞里	凹洞裡
须毛	鬚毛
拔须	拔鬚
六出祁山	六出祁山
好斗膽	好斗膽
暗沟里	暗溝裡
关系着	關係著
有著稱	有著稱
系风捕影	繫風捕影
猜著稱	猜著稱
购并	購併
福著者	福著者
面汤	麵湯
征才	徵才
曰云	曰云
借着	藉著
出乖弄丑	出乖弄醜
嘴里	嘴裡
于光遠	于光遠
胫	脛
于是之	于是之
复仞年如	複仞年如
求著書	求著書
洛钟东应	洛鐘東應
荷花淀	荷花澱
会占卜	會占卜
千只可	千只可
一年	一年
手表面	手表面
赶制	趕製
醯雞	醯雞
采石磯	采石磯
泡面	泡麵
千里達托貝哥	特立尼達和多巴哥
溺于	溺於
谷物	穀物
龟山庄	龜山庄
辟佛	闢佛
辟作	闢作
征稿	徵稿
奖	獎
跟著書	跟著書
拿著作	拿著作
盾著書	盾著書
奁	奩
奂	奐
征逐	徵逐
九出版	九出版
茅利塔尼亞	毛里塔尼亞
鬥著述	鬥著述
献丑	獻醜
卷帘	捲簾
征选	徵選
征税	徵稅
仇問	讎問
關著述	關著述
人参阅	人參閱
表征	表徵
朱仑街	朱崙街
吊旗	弔旗
挂图	挂圖
肠	腸
肿	腫
肾	腎
瓜地馬拉	危地馬拉
肴	餚
则	則
表的历史	錶的歷史
采暖	採暖
定准	定準
缝里	縫裡
２余	２餘
肃	肅
志哀	誌哀
什锦面	什錦麵
范金	範金
斗弄	鬥弄
息谷	息穀
凶杀案	凶殺案
扎诈	紮詐
儒略改革历	儒略改革曆
编余	編余
地方志	地方志
吃着不尽	吃著不盡
作奸犯科	作姦犯科
后发星系团	后髮星系團
丁丁当当	丁丁當當
搤肮拊背	搤肮拊背
个里	個裡
范数	範數
趱干	趲幹
渖	瀋
拾沈	拾瀋
咕咕钟	咕咕鐘
趴著述	趴著述
晓	曉
飘荡	飄蕩
于乐	於樂
人参议	人參議
借此	藉此
土制	土製
制冷机	制冷機
趸	躉
交哄	交鬨
皇极历史	皇極歷史
躏	躪
会里	會裡
淳于	淳于
拼著稱	拼著稱
躜	躦
鬥著稱	鬥著稱
郁燠	鬱燠
词汇	詞彙
皺著者	皺著者
周三	周三
應著錄	應著錄
抱朴而长吟兮	抱朴而長吟兮
大本钟	大本鐘
躯	軀
万历史	萬歷史
周一	周一
占局部	佔局部
甚么	甚麼
定著述	定著述
回着	回著
斗舰	鬥艦
捍御	捍禦
涌进	湧進
胡髯	鬍髯
胡髭	鬍髭
壮面	壯麵
１余	１餘
撞球	桌球
连三并四	連三併四
余四	餘四
显示钟	顯示鐘
郁泱	鬱泱
药茶	藥茶
宿舍	宿舍
老板	老闆
㟆	㠏
托付	託付
个中滋味	箇中滋味
于和伟	于和偉
炼气	鍊氣
伊于湖底	伊于湖底
啬	嗇
出节目	齣節目
调钟表	調鐘錶
亿余	億餘
候著作	候著作
瑷	璦
瑶	瑤
庄敬	莊敬
表王	錶王
黾	黽
闺范	閨範
准备	準備
五只	五隻
雾	霧
差之毫厘，谬以千里	差之毫釐，謬以千里
謷丑	謷醜
表停	錶停
锈蚀	鏽蝕
采空采穗	採空採穗
占压	佔壓
揾	搵
揿	撳
位准	位準
捵面	捵麵
单干	單幹
旧钟	舊鐘
心系湖	心繫湖
烧干	燒乾
躁郁	躁鬱
干吏	幹吏
任何表达	任何表達
钟表慢	鐘錶慢
卖断发	賣斷發
努著者	努著者
走回路	走回路
罵著書	罵著書
筵几	筵几
烫一个发	燙一個髮
选手表示	選手表示
规范	規範
朴拙	樸拙
棱登	稜登
丰標不凡	丰標不凡
姜桂	薑桂
䦅	鐥
䦁	𨧜
䦀	𨦫
罵著稱	罵著稱
财	財
发上冲冠	髮上沖冠
生锈	生鏽
掖著者	掖著者
贠	貟
卷缩	捲縮
熬药	熬藥
云为	云為
手表演	手表演
干缺	幹缺
管著述	管著述
忙著稱	忙著稱
合并	合并
贬	貶
附著書	附著書
占市场	佔市場
干剥剥	乾剝剝
候著名	候著名
于一役	於一役
恶心	噁心
发松	發鬆
點著者	點著者
严丝合缝	嚴絲合縫
贩	販
兴致	興緻
牽著書	牽著書
贷	貸
寫著錄	寫著錄
幫著	幫着
落著者	落著者
准不准我	准不准我
于物	於物
发状	髮狀
贴	貼
贳	貰
九龍表行	九龍表行
释	釋
贲	賁
震栗	震慄
斗转参横	斗轉參橫
于鬯	于鬯
夏天里	夏天裡
系为	係為
吟游	吟遊
余缺	餘缺
斗志	鬥志
系上	繫上
贻	貽
下签收	下簽收
人参与	人參與
明窗净几	明窗淨几
大只能	大只能
污蔑	污衊
钟塔	鐘塔
要克制	要剋制
系世	繫世
映著書	映著書
红钟	紅鐘
沉淀	沉澱
刿	劌
刽	劊
药棉	藥棉
手表现	手表現
與著作	與著作
喂给	餵給
删	刪
據著作	據著作
发短心长	髮短心長
刬	剗
刭	剄
别	別
从里到外	從裡到外
于乎	於乎
划	劃
雅著稱	雅著稱
刚	剛
创	創
刘	劉
挑著	挑着
于九	於九
卫星钟	衛星鐘
打路庄板	打路莊板
舍身	捨身
发蒙	發矇
舍得	捨得
百科里	百科裡
刍	芻
泱郁	泱鬱
駕著錄	駕著錄
繞著者	繞著者
苧烯	薴烯
单于	單于
卷走	捲走
于光新	于光新
㖊	噚
犹如钟	猶如鐘
只身高	只身高
朴重	樸重
朴野	樸野
寫著作	寫著作
閑著名	閑著名
于韋斯屈萊	于韋斯屈萊
德占	德佔
丑语	醜語
揩干	揩乾
占后	佔後
留著述	留著述
干冷	乾冷
欧游	歐遊
遗	遺
争妍斗奇	爭妍鬥奇
关系	關係
穿著述	穿著述
蒙聩	矇聵
干冰	乾冰
秋假裡	秋假裏
铽	鋱
捆著稱	捆著稱
觞	觴
走著書	走著書
努著稱	努著稱
觐	覲
觑	覷
觎	覦
华乐	中樂
觌	覿
觍	覥
觊	覬
觋	覡
览	覽
觉	覺
视	視
觇	覘
靠著述	靠著述
觅	覓
观	觀
觃	覎
称	稱
味著者	味著者
准保护	准保護
数字钟	數字鐘
苦著書	苦著書
涂醒哲	涂醒哲
干干净净	乾乾淨淨
只身边	只身邊
卷须	卷鬚
堕胎药	墮胎藥
于吉	于吉
勾心斗角	勾心鬥角
触	觸
學著稱	學著稱
冒著稱	冒著稱
口干政	口干政
炮制	炮製
干式	乾式
鋪著述	鋪著述
秾	穠
喂鸡	餵雞
荡荡	蕩蕩
能干休	能干休
有征讨	有征討
試著作	試著作
谷壳	穀殼
打著者	打著者
落著書	落著書
汤下面	湯下麵
大卫·贝克汉姆	大衛碧咸
醜著作	醜著作
揪采	揪採
踩著書	踩著書
强制作用	強制作用
三出生	三出生
胜键	胜鍵
脶	腡
施舍之道	施舍之道
落著稱	落著稱
资金占用	資金占用
采收	採收
结扎	結紮
梳著者	梳著者
秋裤	秋褲
斗趣	鬥趣
康著稱	康著稱
义占	義佔
弘历史	弘歷史
特制止	特制止
向迩	嚮邇
于震	于震
风范	風範
脓	膿
脑	腦
占亿	佔億
好家伙	好傢夥
干性	乾性
脚	腳
佣金	傭金
表带	錶帶
轩辟	軒闢
掙著名	掙著名
六扎	六紮
脍	膾
脾脏	脾臟
脉	脈
庄严	莊嚴
洪范	洪範
余切	餘切
余刃	餘刃
药行	藥行
敌忾同仇	敵愾同讎
云须	雲鬚
归并	歸併
高度自制	高度自制
毕于	畢於
夜里	夜裡
近日里	近日裡
寓于	寓於
逞凶鬥狠	逞兇鬥狠
历纪	曆紀
觏	覯
这么着	這麼著
鞋里	鞋裡
凉面	涼麵
朱理安历史	朱理安歷史
先采	先採
磁制	磁製
斗叠	鬥疊
缘	緣
缙	縉
缚	縛
缛	縟
缜	縝
漫著錄	漫著錄
缞	縗
缟	縞
曲菌	麴菌
缑	緱
缒	縋
踏著者	踏著者
缔	締
0年	0年
编	編
缗	緡
缈	緲
缉	緝
缊	縕
缋	繢
缌	緦
缍	綞
缎	緞
缏	緶
缀	綴
缁	緇
缂	緙
缃	緗
缄	緘
不吊	不弔
缆	纜
闯荡	闖蕩
闲游	閒遊
并案	併案
演著作	演著作
朴厚	樸厚
領著作	領著作
缰	韁
缱	繾
缲	繰
缳	繯
缴	繳
缵	纘
缨	纓
缩	縮
缪	繆
秆	稈
缬	纈
缭	繚
缮	繕
缯	繒
缠	纏
缡	縭
缢	縊
见	見
缤	繽
占〇	佔〇
缦	縵
彼此克制	彼此剋制
崖广	崖广
松土	鬆土
回历史	回歷史
格范	格範
胃里	胃裡
不干他	不干他
垄断资产	壟斷資產
呆呆笨笨	呆呆笨笨
荐饥	荐饑
剪发	剪髮
不斗胆	不斗膽
携	攜
搅	攪
于田	于田
搁	擱
合历史	合歷史
搂	摟
使其斗	使其鬥
置于	置於
３天后	３天後
转台	轉檯
揮著述	揮著述
年谷	年穀
详征博引	詳徵博引
棱缝	稜縫
抬著錄	抬著錄
穿著書	穿著書
眼眶里	眼眶裡
内面包	內面包
大呆	大獃
夜光表	夜光錶
瓯	甌
瓒	瓚
准平原	準平原
觯	觶
依托	依託
颤栗	顫慄
照著	照着
别气	彆氣
旁注	旁註
葱	蔥
循著述	循著述
周四	周四
丝制	絲製
计	計
膠著稱	膠著稱
占平均	佔平均
夏游	夏遊
委托书	委託書
讣	訃
占零	佔零
躍著	躍着
据	據
对准钟	對準鐘
落著作	落著作
药铺	藥鋪
隶	隸
盐打怎么咸	鹽打怎麼鹹
應著	應着
捣	搗
难	難
捡	撿
捞	撈
损	損
捝	挩
康庄	康莊
響著錄	響著錄
随	隨
隐	隱
８天后	８天後
八出口	八出口
钟速	鐘速
讨	討
年里	年裡
阴干	陰乾
卷尺	捲尺
喂鸭	餵鴨
西历	西曆
绣衣	繡衣
朴父	樸父
只占	只佔
签条	籤條
讯	訊
孪	孿
毕生发展	畢生發展
五出祁山	五出祁山
讲	講
懷著名	懷著名
托命	託命
白净面皮	白淨面皮
讵	詎
拼老命	拚老命
寡占	寡佔
顺钟向	順鐘向
馬自達	萬事得
教于	教於
壮	壯
讶	訝
锻炼出	鍛鍊出
懔栗	懍慄
口钟	口鐘
城里	城裡
壶	壺
紧绷绷	緊繃繃
壳	殼
夸能斗智	誇能鬥智
扫荡	掃蕩
壸	壼
钟罩	鐘罩
演著	演着
台灯	檯燈
晒种	晒種
９年	９年
干眼	乾眼
注释	注釋
卤汁	滷汁
古語云	古語云
林钟	林鐘
努著名	努著名
涸干	涸乾
吹著者	吹著者
神雕	神鵰
占ｙ	佔ｙ
低著作	低著作
才干休	才干休
淀积	澱積
庑	廡
签幐	籤幐
枕著名	枕著名
准头	準頭
伴著名	伴著名
龙须	龍鬚
手里剑	手裏劍
５年	５年
张三丰	張三丰
拼命	拚命
叮叮当当	叮叮噹噹
陪著名	陪著名
鬅松	鬅鬆
雪里蕻	雪裡蕻
愤	憤
系于	繫於
心系老	心繫老
閑著稱	閑著稱
冻	凍
咸粥	鹹粥
地克制	地剋制
冲	沖
决	決
况	況
踏著述	踏著述
嚷著述	嚷著述
戀著作	戀著作
挨著者	挨著者
正在叱咤	正在叱咤
含著書	含著書
庆	慶
写	寫
军	軍
农	農
紮著述	紮著述
困著	困着
公仆	公僕
亮著書	亮著書
届	屆
册	冊
粉签子	粉籤子
冁	囅
待著作	待著作
内	內
采食	採食
官地为采	官地為寀
慣著者	慣著者
余闲	餘閒
农历史	農歷史
今天	今天
采风	採風
郁火	鬱火
鲘	鮜
吃药	吃藥
屃	屓
范贤惠	范賢惠
板着脸	板著臉
锈菌	鏽菌
从里向外	從裡向外
几子	几子
个中强手	箇中強手
向著錄	向著錄
不谷	不穀
后妃	后妃
會干擾	會干擾
趕著作	趕著作
制糖	製糖
赌后	賭后
余三胜	余三勝
万多只	萬多隻
六冲	六衝
干掉	幹掉
急著稱	急著稱
脑子里	腦子裡
黏著者	黏著者
万俟	万俟
聽著	聽着
饥寒	饑寒
准不准他	准不准他
雪铁龙	先進
郁江	鬱江
扎营	紮營
硬體	硬件
百拙千丑	百拙千醜
余姓	余姓
余姚	餘姚
帶著者	帶著者
白霉	白黴
忙著作	忙著作
滑借	滑藉
虫	蟲
虬	虯
犹如表	猶如錶
虮	蟣
心系阮	心繫阮
对折	對摺
拉面部	拉面部
凭几	憑几
虾	蝦
虿	蠆
自觉自愿	自覺自愿
黑发	黑髮
脱	脫
颂系	頌繫
悲筑	悲筑
快速面	即食麵
虑	慮
芦	蘆
吊鹤	弔鶴
虚	虛
尼日利亚	尼日利亞
達著名	達著名
尼日利亞	尼日利亞
过杆	過杆
盯著書	盯著書
咏	詠
游说	遊說
忠仆	忠僕
并不准确	並不準確
脸	臉
主钟差	主鐘差
春假裡	春假裏
干营生	幹營生
折尺	摺尺
𩽾	鮟
凯	凱
𩽼	鯶
𩽽	𩶱
𩽺	𩵩
𩽻	𩵹
𩽹	魥
语汇	語彙
載著錄	載著錄
来于	來於
克扣	剋扣
逊于	遜於
自行车	單車
麻醉药	麻醉藥
垄	壟
模里西斯	毛里裘斯
千只	千隻
辟辟	闢辟
短发	短髮
映著述	映著述
空钟	空鐘
占总	佔總
计划	計劃
余食	餘食
采购	採購
余风	餘風
睡游病	睡遊病
浔	潯
松起	鬆起
酽	釅
浓	濃
浐	滻
浑	渾
酱	醬
羁	羈
浆	漿
浇	澆
脔	臠
浃	浹
連著作	連著作
浏	瀏
赤术	赤朮
骨干	骨幹
浊	濁
松散	鬆散
冶游	冶遊
酦	醱
燕游	燕遊
酝	醞
于于	于于
９余	９餘
脐	臍
軟體	軟件
行著者	行著者
那么	那麼
酂	酇
鲔	鮪
雜著名	雜著名
薄幸	薄倖
羡	羨
薄干	薄幹
吊奠	弔奠
昆仑	崑崙
个中奥秘	箇中奧秘
垒	壘
塞普勒斯	塞浦路斯
枝干	枝幹
三统历史	三統歷史
留著	留着
残余	殘餘
砻谷机	礱穀機
0周后	0周後
厄瓜多	厄瓜多爾
買凶	買兇
形单影只	形單影隻
之托	之託
干着	乾著
行著書	行著書
炖药	燉藥
山里	山裡
困乏	睏乏
鲖	鮦
浩浩荡荡	浩浩蕩蕩
于大寶	于大寶
出电影	齣電影
齑	齏
齐	齊
断	斷
相克服	相克服
故事里	故事裡
十出祁山	十出祁山
冬游	冬遊
业余	業餘
脏	臟
齄	齇
御寒	禦寒
两虎共斗	兩虎共鬥
閑著者	閑著者
梳著錄	梳著錄
素朴	素樸
曲钱	麴錢
斋	齋
戰著述	戰著述
于國治	于國治
妙药	妙藥
百只怕	百只怕
医药	醫藥
齿	齒
炼度	鍊度
油面	油麵
没折至	沒摺至
斓	斕
逆钟向	逆鐘向
个	個
唱著作	唱著作
涌出	湧出
冒著作	冒著作
花钟	花鐘
斗气	鬥氣
進制	進制
拘于	拘於
心著書	心著書
學著書	學著書
七周后	七周後
千回百转	千迴百轉
墓志	墓誌
帶著述	帶著述
那只能	那只能
晚钟	晚鐘
5天后	5天後
周历史	周歷史
達著書	達著書
郁林	鬱林
䇲	筴
昂著名	昂著名
千天后	千天後
编发	編髮
丝	絲
轉著稱	轉著稱
船只	船隻
要占	要佔
丛	叢
舍本逐末	捨本逐末
折子戏	折子戲
斥著書	斥著書
表里	表裡
面浆	麵漿
聖馬利諾	聖馬力諾
余沥	餘瀝
高著作	高著作
藝著稱	藝著稱
身著述	身著述
十多只	十多隻
弹药	彈藥
拼生尽死	拚生盡死
余绪	餘緒
钟座	鐘座
细炼	細鍊
躍著者	躍著者
专	專
不药而愈	不藥而癒
點著稱	點著稱
叱咤乐坛	叱咤樂壇
潇洒	瀟洒
梳著名	梳著名
百只可	百只可
忍著名	忍著名
彩排	綵排
零余	零餘
㺍	獱
不采	不採
往复	往複
据干而窥井底	據榦而窺井底
草荐	草荐
9周后	9周後
拉纤	拉縴
涌泉	湧泉
万	萬
逼著書	逼著書
余利	餘利
斗饤	鬥飣
心著名	心著名
购买欲	購買慾
松山庄	松山庄
悸栗	悸慄
算历	算曆
世纪钟表	世紀鐘錶
表店	錶店
给我干脆	給我干脆
稳占	穩佔
麻药	麻藥
黏著述	黏著述
厝薪于火	厝薪於火
人参观	人參觀
人参见	人參見
瞞著者	瞞著者
只身	隻身
弹珠台	彈珠檯
地占	地佔
膑	臏
姜汁	薑汁
悠游	悠遊
下签字	下簽字
蒙松雨	濛鬆雨
红色长发	紅色長髮
二老板	二老板
假药	假藥
人参	人蔘
面筋	麵筋
四扎	四紮
倛丑	倛醜
余力	餘力
治愈	治癒
鸡蛋里挑骨头	雞蛋裡挑骨頭
𪉉	𪁈
郁朴	郁樸
只身体	只身體
余一	餘一
視如寇仇	視如寇讎
采料	採料
铁栏杆	鐵欄杆
于山	于山
宝山庄	寶山庄
伴著	伴着
满满当当	滿滿當當
面朝着	面朝著
光著	光着
看著書	看著書
演著稱	演著稱
喝著作	喝著作
早于	早於
辐	輻
输	輸
辒	轀
辕	轅
鹤发	鶴髮
辗	輾
辖	轄
髭著名	髭著名
辘	轆
覆没	覆沒
复赛	複賽
辞	辭
辁	輇
辀	輈
较	較
辂	輅
接著名	接著名
辄	輒
辇	輦
辆	輛
辉	輝
偷著錄	偷著錄
辋	輞
余下	餘下
辍	輟
辌	輬
辏	輳
缝	縫
２周后	２周後
绷住	繃住
边	邊
辽	遼
舍我其谁	捨我其誰
尚比亞	贊比亞
沃尓沃	富豪
遠著作	遠著作
辩	辯
辫	辮
凶相	兇相
诗余	詩餘
吊带裤	吊帶褲
缓	緩
咸度	鹹度
药粉	藥粉
沙烏地阿拉伯	沙特阿拉伯
有只	有隻
缕	縷
退伙	退夥
锈病	鏽病
万余	萬餘
余外	餘外
经有云	經有云
心系您	心繫您
丹药	丹藥
游船	遊船
郁热	鬱熱
峻岭	峻岭
盾著者	盾著者
尽是	儘是
扑作教刑	扑作教刑
幫著書	幫著書
溢著述	溢著述
挨著名	挨著名
往日無仇	往日無讎
味著稱	味著稱
矜庄	矜莊
之八九只	之八九只
纵欲	縱慾
确瘠	确瘠
7只支持	7只支持
睑	瞼
芜	蕪
缅	緬
天干物燥	天乾物燥
睁	睜
唱著稱	唱著稱
尽快	儘快
听于	聽於
佳里鎮	佳里鎮
有只是	有只是
著實	着實
零周后	零周後
泪如泉涌	淚如泉湧
余泽	餘澤
呆头	獃頭
鲼	鱝
空著書	空著書
余波	餘波
阳	陽
7年	7年
阶	階
于國楨	于國楨
阴	陰
家里	家裡
阊	閶
阋	鬩
阈	閾
参观团体	參觀團體
因著述	因著述
阏	閼
阌	閿
阍	閽
阂	閡
阃	閫
纏著述	纏著述
纡郁	紆鬱
贪欲	貪慾
鲽	鰈
阄	鬮
４天后	４天後
阚	闞
阛	闤
阘	闒
阙	闕
松气	鬆氣
女仆	女僕
阒	闃
阓	闠
阐	闡
於梨華	於梨華
阖	闔
阗	闐
阔	闊
阕	闋
七情六欲	七情六慾
赵庄	趙莊
陪著	陪着
扁拟谷盗虫	扁擬穀盜蟲
旧钟表	舊鐘錶
斗蟋蟀	鬥蟋蟀
位于	位於
之二只	之二只
洁	潔
䢂	𨋢
羁系	羈繫
末药	末藥
試著名	試著名
斗犬	鬥犬
缫	繅
船钟	船鐘
心系哪	心繫哪
好于	好於
儿	兒
后发FK型星	后髮FK型星
占苏	佔蘇
滞	滯
滟	灧
两年	兩年
面包装	面包裝
挽聯	輓聯
采办	採辦
好斗篷	好斗篷
滗	潷
茂都淀	茂都澱
應著作	應著作
猛于	猛於
與著名	與著名
戬谷	戩穀
缣	縑
著力	着力
谷草	穀草
减肥药	減肥藥
豎著	豎着
備著名	備著名
谷粒	穀粒
罩著	罩着
滪	澦
面包裹	面包裹
精于	精於
滠	灄
性著者	性著者
滢	瀅
缧	縲
滤	濾
滥	濫
滦	灤
钟好	鐘好
鲲	鯤
天覆地载	天覆地載
隨著述	隨著述
裝著作	裝著作
准拟	準擬
喂过	餵過
绷脸	繃臉
高涌泉	高涌泉
蓬发	蓬髮
丑化	醜化
商历	商曆
于是	於是
于三	於三
固征	固徵
標誌著	標誌着
饲喂	飼餵
夸夸其谈	夸夸其談
奸夫	姦夫
于你	於你
彻	徹
干爸	乾爸
脚注	腳註
百个	百個
占3	佔3
干苔	乾苔
于何	於何
抬著	抬着
卷儿	捲兒
散伙	散夥
征用	徵用
累堆	纍堆
有著作	有著作
难舍	難捨
药检局	藥檢局
俭仆	儉僕
占9	佔9
涌入	湧入
斗嘴	鬥嘴
团子	糰子
與著錄	與著錄
黄钰筑	黃鈺筑
丑闻	醜聞
肾脏	腎臟
白干儿	白干兒
薝卜	薝蔔
斗犀台	鬥犀臺
忠人之托	忠人之托
蒙雾露	蒙霧露
披著述	披著述
母丑	母醜
药性	藥性
朝著述	朝著述
准不准谁	准不准誰
发姐	髮姐
占地	佔地
搀	攙
小型钟面	小型鐘面
眼药	眼藥
夸毗	夸毗
棱锥	稜錐
征集	徵集
雪窗萤几	雪窗螢几
药面儿	藥麵兒
禅	禪
摟著作	摟著作
自制地	自制地
備著書	備著書
蛮	蠻
丝来线去	絲來線去
制版	製版
制片	製片
不准你	不准你
一干弟兄	一干弟兄
占T	佔T
龙眼干	龍眼乾
鲫	鯽
樂著書	樂著書
占U	佔U
蛲	蟯
蛳	螄
蛰	蟄
蛱	蛺
跑著	跑着
志异	誌異
吊裤带	吊褲帶
逆著者	逆著者
姜饼	薑餅
蛏	蟶
花药	花藥
阿呆瓜	阿呆瓜
斗话	鬥話
采珠	採珠
防锈	防鏽
独辟蹊径	獨闢蹊徑
征到	徵到
青苹	青苹
耧	耬
夸姣	夸姣
占国内	佔國內
耀著述	耀著述
托卖	託賣
万年历表	萬年曆錶
希伯来历史	希伯來歷史
空荡	空蕩
绣阁	繡閣
换签	換籤
大病初愈	大病初癒
占有权	占有權
余味	餘味
纤手	縴手
宝里宝气	寶裡寶氣
四出口	四出口
余8	餘8
余9	餘9
于山國	于山國
府干涉	府干涉
余2	餘2
余3	餘3
余0	餘0
余1	餘1
发霜	髮霜
盯著者	盯著者
余4	餘4
余5	餘5
吊死	弔死
红发	紅髮
烟卷	煙捲
占O	佔O
嶒棱	嶒稜
占L	佔L
拼死拼活	拼死拼活
询于刍荛	詢於芻蕘
代表	代表
草药	草藥
占J	佔J
舍己救人	捨己救人
关弓与我确	關弓與我确
喝干	喝乾
占H	佔H
姜母	薑母
咎征	咎徵
谋干	謀幹
扑打	扑打
得克制	得剋制
断发文身	斷髮文身
馆里	館裡
赞叹不已	讚嘆不已
拿著錄	拿著錄
秋天裡	秋天裏
奴仆	奴僕
粝	糲
有恒街	有恒街
什么	什麼
衣绣昼行	衣繡晝行
味著述	味著述
于己	於己
骨头里挣出来的钱才做得肉	骨頭裡掙出來的錢纔做得肉
蓝淀	藍澱
于差	於差
不寒而栗	不寒而慄
七出生	七出生
心著稱	心著稱
划了一会	划了一會
罵著錄	罵著錄
展著者	展著者
齿落发白	齒落髮白
不斗膽	不斗膽
八余	八餘
沉著書	沉著書
手折	手摺
向往来	向往來
干嘛	幹嘛
身著書	身著書
谷食	穀食
借听于聋	借聽於聾
三天后	三天後
测试	測試
占b	佔b
舍安就危	捨安就危
雄斗斗	雄斗斗
大周折	大週摺
鳛	鰼
鳚	䲁
鳙	鱅
鳘	鰵
鳟	鱒
跌扑	跌扑
鳝	鱔
协	協
轉著書	轉著書
鳒	鰜
鳑	鰟
鳐	鰩
鳗	鰻
鳖	鱉
洒濯	洒濯
只身段	只身段
鳋	鰠
鳊	鯿
鳉	鱂
鳈	鰁
咸食	鹹食
低著稱	低著稱
鳍	鰭
鳌	鰲
炼师	鍊師
鳂	鰃
鳁	鰮
鲦	鰷
鳇	鰉
盯著	盯着
鳅	鰍
鳄	鱷
差于	差於
攒	攢
2周后	2周後
3只支持	3只支持
占領	佔領
买断发	買斷發
豫著作	豫著作
占便宜	佔便宜
７天后	７天後
迂回	迂迴
鳣	鱣
鳢	鱧
鳡	鱤
鳠	鱯
注：	註：
鬓	鬢
矿	礦
矾	礬
干饭	乾飯
矶	磯
奸细	姦細
刚才一载	剛纔一載
矫	矯
魏征	魏徵
颂赞	頌讚
厘正	釐正
于仲文	于仲文
𪡏	嗹
占查	佔查
半制品	半制品
一干家中	一干家中
俪	儷
配著	配着
拉面前	拉面前
玉历	玉曆
紮著書	紮著書
鞯	韉
㖞	喎
内制	內製
青苹果	青蘋果
并线	併線
面临着	面臨著
辟室	闢室
禁欲主义	禁欲主義
掙著稱	掙著稱
铲刈	剷刈
游历	遊歷
请求	請求
丑虏	醜虜
提著錄	提著錄
鞑	韃
于蓝	於藍
崂	嶗
落著名	落著名
上签名	上簽名
金表态	金表態
炸酱面	炸醬麵
干乔	乾喬
采回	採回
刻著述	刻著述
老干	老乾
绕梁	繞樑
日历史	日歷史
物理学家	物理學家
药名	藥名
盾著名	盾著名
７只	７隻
守著書	守著書
福著書	福著書
得著名	得著名
昂著書	昂著書
于呼哀哉	於呼哀哉
持著名	持著名
擺著名	擺著名
忾	愾
忧	憂
金范	金範
未干涉	未干涉
黎吉雲	黎吉雲
占多	佔多
福著稱	福著稱
占大	佔大
側著作	側著作
硬件	硬件
制表	製表
药材	藥材
管著者	管著者
扑冬	撲鼕
忆	憶
采芹人	採芹人
忏	懺
天历史	天歷史
干虔	乾虔
猪	豬
采风问俗	採風問俗
于奇库杜克	于奇庫杜克
驻扎	駐紮
金布道	金布道
献	獻
斗智	鬥智
數著錄	數著錄
后稷	后稷
索面	索麵
隽	雋
看着钟	看著鐘
隆准许	隆准許
趕著者	趕著者
采信	採信
困斗	困鬥
挑大梁	挑大樑
才克制	才剋制
4年	4年
抬著述	抬著述
乌龙面	烏龍麵
乘著名	乘著名
展著述	展著述
坦荡荡	坦蕩蕩
起复	起複
青蝇吊客	青蠅弔客
提著作	提著作
吉凶庆吊	吉凶慶弔
奸妇	姦婦
㛿	𡠹
自制服	自制服
面包起	面包起
揉著者	揉著者
㛠	𡢃
卷动	捲動
頂著	頂着
斗争斗合	鬥爭鬥合
飘飘荡荡	飄飄蕩蕩
郁陶	鬱陶
协防	協防
谛	諦
谚	諺
谙	諳
與著者	與著者
谟	謨
黃詩杰	黃詩杰
谝	諞
谜	謎
谓	謂
物欲	物慾
谑	謔
谐	諧
谗	讒
谖	諼
谕	諭
行百里者半于九十	行百里者半於九十
谋	謀
两个	兩個
綁著	綁着
谈	談
谏	諫
谎	謊
凭借着	憑藉著
谌	諶
俦	儔
見著者	見著者
谁	誰
搽药	搽藥
谇	誶
谆	諄
谅	諒
机器人	機械人
朴学	樸學
佣懒	傭懶
控制	控制
不干	不幹
核准的	核准的
谲	譎
谱	譜
谰	讕
谶	讖
谵	譫
谴	譴
谫	譾
谪	謫
谩	謾
谨	謹
谯	譙
谮	譖
谭	譚
谬	謬
谣	謠
谢	謝
谡	謖
谠	讜
谧	謐
谦	謙
谥	謚
谤	謗
腊味	腊味
仇正	讎正
退藏于密	退藏於密
動著書	動著書
赪	赬
涌起	湧起
庄周	莊周
会吊	會弔
向导	嚮導
罵著者	罵著者
七出祁山	七出祁山
靠著	靠着
罩著述	罩著述
四周后	四周後
剪牡丹喂牛	剪牡丹喂牛
伊斯兰历史	伊斯蘭歷史
馬爾地夫	馬爾代夫
高干	高幹
干子	乾子
组里	組裡
好干	好乾
钟意	鐘意
牽著	牽着
燒著稱	燒著稱
更仆难数	更僕難數
蝾	蠑
因于	因於
唱著名	唱著名
戀著名	戀著名
蝎	蠍
松元音	鬆元音
蝉	蟬
跪著稱	跪著稱
蝇	蠅
受著作	受著作
干季	乾季
窝里	窩裡
刮倒	颳倒
冲到	衝到
備著	備着
复壁	複壁
撇吊	撇弔
帶著錄	帶著錄
對著名	對著名
小只	小隻
姜蓉	薑蓉
病余	病餘
药瓶	藥瓶
警示钟	警示鐘
重罗面	重羅麵
进制	進制
年代裡	年代裏
关于	關於
复壮	複壯
并吞	并吞
赃	贓
努力著稱	努力著稱
亮著	亮着
通奸	通姦
伙众	夥眾
順著	順着
绷扒吊拷	繃扒弔拷
跟著作	跟著作
5余	5餘
几天后	幾天後
没准	沒準
冲刺	衝刺
并合	併合
回丝	回絲
弃舍	棄捨
冲决	衝決
捆扎	捆紮
犯不著	犯不着
腕表	腕錶
伣	俔
疑凶	疑兇
传	傳
伧	傖
伦	倫
做著書	做著書
秋阴入井干	秋陰入井幹
伫	佇
伪	偽
拎著名	拎著名
傥	儻
桢干	楨幹
干线	幹線
盒里	盒裡
河岳	河嶽
伛	傴
只身體	只身體
返朴	返樸
卷纸	捲紙
傩	儺
丑于	醜於
騎著作	騎著作
赗	賵
率团参加	率團參加
村落发	村落發
里程表	里程錶
皇历史	皇歷史
府干扰	府干擾
與著	與着
鬓发	鬢髮
郁垒	鬱壘
𫌨	覼
湾	灣
邱于庭	邱于庭
占起	佔起
才干预	才干預
鸡只	雞隻
希特勒	希特拉
蓋亞那	圭亞那
游子	遊子
多只会	多只會
𫌀	襀
有仆	有僕
赚	賺
游人	遊人
回形夹	迴形夾
谷苗	穀苗
纮	紘
纯	純
纬	緯
纭	紜
涂逢年	涂逢年
纫	紉
纨	紈
纩	纊
约	約
级	級
纤	纖
雅著書	雅著書
红	紅
纣	紂
纠	糾
纡	紆
纾	紓
干癣	乾癬
纼	紖
纽	紐
任何钟	任何鐘
纻	紵
纸	紙
纹	紋
纶	綸
纷	紛
纴	紝
纵	縱
纲	綱
纳	納
纰	紕
纱	紗
庙	廟
著眼	着眼
纟	糹
在著稱	在著稱
护发	護髮
困倦	睏倦
夢著述	夢著述
阴历	陰曆
这伙人	這夥人
历狱	曆獄
玉历史	玉歷史
䁖	瞜
锤儿	鎚兒
欲火	慾火
米谷	米穀
鱽	魛
鱼	魚
鱿	魷
鱾	魢
著陸	着陸
辦著名	辦著名
掖著述	掖著述
特征	特徵
剃胡	剃鬍
两只	兩隻
占领	佔領
打著名	打著名
生物钟	生物鐘
山庄	山莊
钟乳洞	鐘乳洞
绘制	繪製
捆著作	捆著作
戀著稱	戀著稱
二不棱登	二不稜登
哄堂大笑	哄堂大笑
印表機	打印機
阳历史	陽歷史
钟响	鐘響
生于	生於
实干	實幹
管制法	管制法
斗风	鬥風
至于	至於
字節	位元組
绷着脸儿	繃著臉兒
余悸	餘悸
干井	乾井
冗余	冗餘
紮著錄	紮著錄
丑夷	醜夷
雅著者	雅著者
枝不得大于干	枝不得大於榦
十天后	十天後
诬蔑	誣衊
硗确	磽确
石梁	石樑
钟磬	鐘磬
四个	四個
懷著書	懷著書
干电	乾電
擺著者	擺著者
粤	粵
苑里	苑裡
涼著述	涼著述
水里鄉	水里鄉
机械钟表	機械鐘錶
于夫罗	於夫羅
雅致	雅緻
叫著者	叫著者
瞞著書	瞞著書
声	聲
征婚	徵婚
钟不撞不鸣	鐘不撞不鳴
八出逃	八出逃
豎著錄	豎著錄
雜著稱	雜著稱
沈州	瀋州
征询	徵詢
采光	採光
尼日尔	尼日爾
长历	長曆
钟律	鐘律
对表中	對表中
打著述	打著述
伴游	伴遊
药厂	藥廠
发指	髮指
发网	髮網
延历	延曆
注标	註標
叶 恭弘	叶 恭弘
侵并	侵併
许虬	許虬
采行	採行
这只用	這只用
游离份子	遊離份子
彦	彥
五年	五年
埃及艳后	埃及豔后
个人	個人
凭折	憑摺
秋游	秋遊
录	錄
当	當
归	歸
用药	用藥
辑	輯
里弦	裡弦
礼赞	禮讚
二只得	二只得
干事	幹事
虎须	虎鬚
表冠	錶冠
數著者	數著者
烫发	燙髮
主干	主幹
曲霉	麴黴
０周后	０周後
共和历史	共和歷史
愛著	愛着
6天后	6天後
繞著稱	繞著稱
粮	糧
陆游	陸遊
制程	製程
燕几	燕几
有事之无范	有事之無範
回游	回遊
屋梁	屋樑
低著	低着
助于	助於
老爷钟	老爺鐘
淬炼	淬鍊
忍著書	忍著書
制著者	制著者
𩾃	鮸
自于	自於
昂著稱	昂著稱
挨著作	挨著作
𩾁	鯄
康庄大道	康庄大道
苦著稱	苦著稱
准谱	準譜
俭确之教	儉确之教
揉著錄	揉著錄
𩾅	𩸃
采撷	採擷
閉著錄	閉著錄
只占神问卜	只占神問卜
呆气	獃氣
齿危发秀	齒危髮秀
土豆网	土豆網
钱谷	錢穀
百只足够	百只足夠
系列里	系列裡
唾余	唾餘
爭著錄	爭著錄
走著稱	走著稱
吊颈	弔頸
逋发	逋髮
荐臻	荐臻
涂着	塗著
鄉愿	鄉愿
没药	沒藥
占整体	佔整體
于山国	于山國
公干	公幹
游手好闲	遊手好閒
施药	施藥
疑著書	疑著書
心系高	心繫高
偷著作	偷著作
撼著述	撼著述
伊郁	伊鬱
踩著述	踩著述
余孽	餘孽
見著稱	見著稱
警戒著	警戒着
口腹之欲	口腹之慾
电钟	電鐘
余子	餘子
咸得	鹹得
頂著稱	頂著稱
同余	同餘
台子孙	台子孫
毫厘	毫釐
余存	餘存
天文学钟	天文學鐘
得著述	得著述
二出口	二出口
志著錄	志著錄
供制	供製
饥溺	饑溺
奸邪	姦邪
不克制	不剋制
兼并	兼并
变丑	變醜
痨	癆
覆辙	覆轍
龛	龕
转斗千里	轉鬥千里
眼里	眼裡
心系北	心繫北
亦庄亦谐	亦莊亦諧
府干预	府干預
怎么着	怎麼著
尘	塵
余响	餘響
占不占	佔不佔
裹著書	裹著書
5年	5年
釀著作	釀著作
尔	爾
笑著作	笑著作
发着	發著
余数	餘數
门里	門裡
𫓩	鏦
会上签署	會上簽署
字节	位元組
這里	這裏
霡	霢
朱笔	硃筆
癞	癩
只身上沒	只身上沒
凌蒙初	凌濛初
咯当	咯噹
癣	癬
占Ｖ	佔Ｖ
圣基茨和尼维斯	聖吉斯納域斯
标签	標籤
癫	癲
配著作	配著作
史瓦濟蘭	斯威士蘭
霁	霽
占Ｓ	佔Ｓ
朱唇皓齿	硃唇皓齒
地心历表	地心曆表
丑头怪脸	醜頭怪臉
于魁智	于魁智
蕴涵着	蘊涵著
侥	僥
侧	側
曲蘖	麴櫱
历元	曆元
侠	俠
侣	侶
绸缎庄	綢緞莊
系结	繫結
侬	儂
侩	儈
侨	僑
侪	儕
緝凶	緝兇
藏蒙歌儿	藏矇歌兒
稀松	稀鬆
心系富	心繫富
干性油	幹性油
語著書	語著書
倾	傾
感冒药	感冒藥
债	債
规	規
钟楼	鐘樓
词余	詞餘
藏著作	藏著作
划龙舟	划龍舟
本著	本着
朴修斯	樸修斯
范文瀾	范文瀾
剃发	剃髮
苹	蘋
潤著書	潤著書
志著作	志著作
南回铁路	南迴鐵路
拂钟无声	拂鐘無聲
唱著錄	唱著錄
能干政	能干政
屉	屜
于火	於火
濒	瀕
哭著述	哭著述
应克制	應剋制
肯尼亚	肯雅
斗巧	鬥巧
出剧	齣劇
面包着	面包著
茶余	茶餘
于素秋	于素秋
准是	準是
于樂	于樂
装折	裝摺
更钟	更鐘
干蛊	幹蠱
采住	採住
候著錄	候著錄
占香	佔香
战斗	戰鬥
托身	託身
准不准你	准不准你
园里	園裡
症结	癥結
矽谷	矽谷
占４	佔４
朴讷	樸訥
准星	準星
节余	節餘
斗起	鬥起
郁金	鬱金
游离	游離
用著者	用著者
于斯塔德	于斯塔德
神雕像	神雕像
占六	佔六
药局	藥局
占八	佔八
占全	佔全
防台	防颱
占停车	佔停車
模棱	模稜
心愿	心愿
范賢惠	范賢惠
占掉	佔掉
廢后	廢后
去著書	去著書
断发	斷髮
蒙著作	蒙著作
紧绷着	緊繃著
韦庄	韋莊
呆脑	獃腦
沿溯	沿泝
格里历	格里曆
占先	佔先
占光	佔光
布雷、	佈雷、
百炼	百鍊
皺著	皺着
裹著錄	裹著錄
肯亞	肯雅
她克制	她剋制
母范	母範
终于	終於
气	氣
著他	着他
醯醬	醯醬
伴著作	伴著作
醯醢	醯醢
肺脏	肺臟
脏得	髒得
恒生	恒生
虫部	虫部
象征着	象徵著
卷发	捲髮
醯醋	醯醋
庄重	莊重
庄里	莊裡
绣得	繡得
卷成	捲成
彩线	綵線
采补	採補
并当	併當
春日里	春日裡
伏几	伏几
專輯裡	專輯裏
于他	於他
冲州撞府	衝州撞府
余罪	餘罪
叶恭弘	叶恭弘
敬挽	敬輓
辈	輩
协调	協調
鹄发	鵠髮
活著	活着
瞪著述	瞪著述
豫著名	豫著名
郑庄公	鄭莊公
弄松	弄鬆
心药	心藥
語著錄	語著錄
心荡	心蕩
飞	飛
獨著者	獨著者
丑辞	醜辭
二只	二隻
壸范	壼範
守著作	守著作
呼吁	呼籲
参合	參合
表壳	錶殼
冈	岡
拉面色	拉面色
罩著稱	罩著稱
丑辱	醜辱
鸿范	鴻範
愿	願
蟏	蠨
下签写	下簽寫
浮著述	浮著述
各辟	各闢
醇朴	醇樸
买	買
集游法	集遊法
借著稱	借著稱
蒙蒙细雨	濛濛細雨
愛著書	愛著書
准据	準據
海上布雷	海上佈雷
新著龍虎門	新著龍虎門
相冲	相衝
于今	於今
复测	複測
背著	背着
黏著書	黏著書
幫著名	幫著名
冲着	衝著
复流	複流
躺著名	躺著名
得著	得着
飄著作	飄著作
辎	輜
游戏	遊戲
伊东怜	伊東怜
于鳳桐	于鳳桐
著想	着想
吊桥	弔橋
采给	採給
坏	壞
广征	廣徵
老干部	老幹部
郁愤	鬱憤
渐	漸
栗栗	慄慄
９周后	９周後
饭团	飯糰
干干儿的	乾乾兒的
圍著書	圍著書
大只需	大只需
古柯咸	古柯鹹
采挖	採挖
燒著者	燒著者
持著作	持著作
喂奶	餵奶
坐著述	坐著述
做庄	做莊
复式	複式
的钟表	的鐘錶
星历史	星歷史
农历	農曆
于敝	於敝
浮著書	浮著書
坐著	坐着
于敏	于敏
乔	喬
复平面	複平面
擞	擻
聖文森及格瑞那丁	聖文森特和格林納丁斯
支干	支幹
扎好	紮好
厘出	釐出
礼	禮
后丰	后豐
生物学家	生物學家
烤干	烤乾
卷住	捲住
溢于	溢於
聽著錄	聽著錄
烫次发	燙次髮
九余	九餘
球杆	球杆
于從濂	于從濂
升平	昇平
跟著者	跟著者
來著	來着
坠	墜
昽	曨
昼	晝
显	顯
看下钟	看下鐘
警钟	警鐘
于荣光	于榮光
余欢	餘歡
睡著名	睡著名
糕干	糕乾
嘀嗒的表	嘀嗒的錶
跳著者	跳著者
摸棱	摸稜
余款	餘款
泪干	淚乾
巷里	巷裡
荡来荡去	蕩來蕩去
本著名	本著名
8年	8年
考著述	考著述
手表露	手表露
踩著稱	踩著稱
呆滞	獃滯
种谷	種穀
积谷防饥	積穀防饑
马格里布	馬格里布
著艦	着艦
煮面	煮麵
干才	幹才
府干預	府干預
假发	假髮
著色	着色
瞪著書	瞪著書
拙朴	拙樸
挂车	挂車
心系功	心繫功
卤湖	滷湖
胡子昂	胡子昂
外制	外製
冲进	衝進
无余	無餘
心系动	心繫動
０余	０餘
须发	鬚髮
卤蛋	滷蛋
钸	鈽
努著錄	努著錄
钺	鉞
游动	遊動
钼	鉬
钽	鉭
钾	鉀
舍近求远	捨近求遠
钰	鈺
钱	錢
钲	鉦
钳	鉗
钴	鈷
洪适	洪适
钶	鈳
钷	鉕
担仔面	擔仔麵
回圈	迴圈
钪	鈧
制药	製藥
钬	鈥
钭	鈄
钮	鈕
钯	鈀
钠	鈉
钡	鋇
钢	鋼
钣	鈑
沉著名	沉著名
钥	鑰
盗	盜
钧	鈞
钘	鈃
钙	鈣
钚	鈈
钛	鈦
钜	鉅
哑	啞
钞	鈔
钟	鍾
疑著者	疑著者
钑	鈒
钒	釩
暗著	暗着
钔	鍆
钕	釹
钖	鍚
钗	釵
瞞著稱	瞞著稱
钟调	鐘調
钊	釗
钋	釙
钌	釕
钍	釷
钎	釺
钏	釧
钅	釒
钆	釓
钇	釔
世田谷	世田谷
于震寰	于震寰
纳征	納徵
涌来	湧來
數著作	數著作
系囚	繫囚
吃不著	吃不着
旗杆	旗杆
咸肉	鹹肉
冲浪	衝浪
谈征	談徵
裹著	裹着
那里	那裡
抱著述	抱著述
药包	藥包
振荡	振蕩
魔杰座	魔杰座
红绳系足	紅繩繫足
提著稱	提著稱
趋	趨
安眠药	安眠藥
石莼	石蓴
廪	廩
𩧪	䮾
閑著書	閑著書
滨田里佳子	濱田里佳子
发表	發表
曲道士	麴道士
脏钱	髒錢
卷铺盖	捲鋪蓋
达	達
会占	會佔
请托	請託
泰山梁木	泰山梁木
心系广	心繫廣
并发表	並發表
药膏	藥膏
菌丝体	菌絲體
诇	詗
缉凶	緝兇
心系幼	心繫幼
歌钟	歌鐘
鋪著者	鋪著者
办公台	辦公檯
𩧬	𩢡
只影	隻影
湘累	湘纍
注记	註記
拉著書	拉著書
心系的	心繫的
光著者	光著者
诀	訣
台面	檯面
髼松	髼鬆
春天里	春天裡
背地里	背地裡
游魂	遊魂
𩧨	駎
拎著作	拎著作
𩧩	𩤊
举手表	舉手表
诌	謅
心理	心理
干不了	幹不了
𩧫	駚
蓄发	蓄髮
古迹	古迹
历日	曆日
后角	后角
身著錄	身著錄
欲令智昏	慾令智昏
诋	詆
于震前	於震前
𩧮	𩢾
卷去	捲去
朴钝	樸鈍
𩧯	驋
连庄	連莊
诖	詿
里头	裡頭
诗	詩
𩧲	駧
𩧳	𩢸
闵采尔	閔採爾
九谷	九穀
𩧵	𩢴
货	貨
精制伏	精制伏
败	敗
雕梁画栋	雕樑畫棟
责	責
本征	本徵
贡	貢
至多	至多
贯	貫
贮	貯
购	購
犬只	狗隻
贫	貧
贪	貪
禁药	禁藥
质	質
彩带	綵帶
贶	貺
贵	貴
须眉	鬚眉
复辅音	複輔音
考著書	考著書
贱	賤
贰	貳
贿	賄
贾	賈
贽	贄
贼	賊
马干	馬乾
贺	賀
费	費
贸	貿
尽先	儘先
𩧻	𩣵
回旋	迴旋
𩧼	𩣺
吹干	吹乾
戴著者	戴著者
马杆	馬杆
鼻准	鼻準
负	負
贞	貞
贝	貝
五出逃	五出逃
騙著名	騙著名
万一只	萬一只
蘸著	蘸着
冲锋	衝鋒
𠮶	嗰
側著名	側著名
冲线	衝線
一吊錢	一吊錢
回采	回採
良药	良藥
印著錄	印著錄
积郁	積鬱
心系香	心繫香
三出版	三出版
征车	徵車
耳余	耳餘
顺于	順於
蛏干	蟶乾
𩧴	駩
九个	九個
还采	還採
诪	譸
采铁	採鐵
空谷回音	空谷回音
綁著稱	綁著稱
归于	歸於
點著作	點著作
语云	語云
松软	鬆軟
清汤挂面	清湯掛麵
不准他	不准他
回避	迴避
诵	誦
美占	美佔
𩧶	𩣏
托儿所	託兒所
钟王	鐘王
复始	復始
备注	備註
这只需	這只需
才干戈	才干戈
发丝	髮絲
據著書	據著書
于垂	於垂
石英表	石英錶
诿	諉
四出生	四出生
复姓	複姓
林宏岳	林宏嶽
药石	藥石
连系	連繫
吹著	吹着
卜云吉	卜云吉
披著稱	披著稱
游览	遊覽
诹	諏
举	舉
签诗	籤詩
乘著	乘着
一个	一個
为	為
临	臨
基干	基幹
丰	豐
暗斗	暗鬥
垅	壠
垆	壚
噙齿戴发	噙齒戴髮
丧	喪
严	嚴
两	兩
面包办	面包辦
丢	丟
拜托	拜託
著絲	着絲
垱	壋
垲	塏
东	東
垴	堖
涂壯勳	涂壯勳
溃于	潰於
阻于	阻於
虽	雖
与	與
志庆	誌慶
垦	墾
筑波	筑波
垩	堊
垫	墊
垭	埡
心系子	心繫子
隨著錄	隨著錄
盯著述	盯著述
𪞝	凙
淀山	澱山
乘著書	乘著書
干生子	乾生子
夏日里	夏日裡
潴	瀦
划不来	划不來
干么	幹麼
潍	濰
也斗了胆	也斗了膽
潋	瀲
鞒	鞽
潆	瀠
潇	瀟
跟著名	跟著名
稆	穭
染殿后	染殿后
睡著者	睡著者
潜	潛
人参照	人參照
忍著	忍着
蒙著錄	蒙著錄
柜上	柜上
管著	管着
欲海	慾海
一伙食	一伙食
雕鹗	鵰鶚
离	離
注销	註銷
爱困	愛睏
夸多斗靡	誇多鬥靡
虏	虜
昨天	昨天
于荫霖	于蔭霖
占6	佔6
占7	佔7
占4	佔4
占5	佔5
占2	佔2
特制订	特制訂
占0	佔0
占1	佔1
文莱	汶萊
中西合并	中西合併
占8	佔8
湟潦生苹	湟潦生苹
康著述	康著述
作品里	作品裡
髯胡	髯鬍
借著書	借著書
辦著	辦着
禀	稟
心系小	心繫小
禄	祿
圍著稱	圍著稱
占V	佔V
占W	佔W
舍不得	捨不得
余喘	餘喘
神荼郁垒	神荼鬱壘
占S	佔S
占P	佔P
占Q	佔Q
䝙	貙
就里	就裡
占Z	佔Z
占X	佔X
占Y	佔Y
占F	佔F
占G	佔G
馆谷	館穀
5周后	5周後
占B	佔B
占C	佔C
心系我	心繫我
占A	佔A
占N	佔N
䗖	螮
手表达	手表達
占M	佔M
吊孝	弔孝
占K	佔K
西药	西藥
占I	佔I
占v	佔v
占w	佔w
占t	佔t
占u	佔u
占r	佔r
占s	佔s
占p	佔p
占q	佔q
占z	佔z
占x	佔x
占y	佔y
占f	佔f
占g	佔g
占d	佔d
占e	佔e
洄游	洄遊
占c	佔c
余殃	餘殃
占n	佔n
占o	佔o
看著	看着
占m	佔m
占j	佔j
占k	佔k
占h	佔h
占i	佔i
踩著者	踩著者
刮风	颳風
哄笑	鬨笑
開著作	開著作
筑北	筑北
谷仓	穀倉
庄院	莊院
丑末	醜末
二个	二個
揮著錄	揮著錄
七天后	七天後
著你	着你
悠著作	悠著作
余威德	余威德
挂历	掛曆
木偶戏扎	木偶戲紮
余酲	餘酲
幞	襆
斗争	鬥爭
心系西	心繫西
金仑溪	金崙溪
山羊胡	山羊鬍
斗了	鬥了
当啷	噹啷
冲杀	衝殺
港制	港製
干没	乾沒
受托	受託
一伙	一夥
干沟	乾溝
于凌辰	于凌辰
闹着玩儿	鬧著玩兒
束发	束髮
分布图	分布圖
附注	附註
专注	專註
占个位	佔個位
系紧	繫緊
骎	駸
日占	日佔
之一只	之一只
手表决	手表決
朴马	樸馬
五谷	五穀
采石矶	采石磯
昂著	昂着
斥著者	斥著者
想著作	想著作
十出刊	十出刊
掙著者	掙著者
面條目	面條目
果子干	果子乾
冲波	衝波
永志不忘	永誌不忘
２天后	２天後
竖着	豎著
扎铁	紮鐵
茶庄	茶莊
蒙著稱	蒙著稱
活著述	活著述
靠著稱	靠著稱
斗百草	鬥百草
茑	蔦
弹子台	彈子檯
里布	裡布
东周钟	東周鐘
擺著錄	擺著錄
領著書	領著書
钟相	鐘相
昆曲	崑曲
㲿	瀇
在著作	在著作
乱哄不过来	亂鬨不過來
腐余	腐餘
代表著作	代表著作
干逼	乾逼
里带	裡帶
万天后	萬天後
提著	提着
窗帘	窗帘
极	極
隆准	隆準
表蒙子	錶蒙子
走著	走着
铲除	剷除
枞	樅
村里	村裡
克死	剋死
印著述	印著述
枧	梘
七年	七年
枥	櫪
枣	棗
枢	樞
枭	梟
派团参加	派團參加
枫	楓
枪	槍
枨	棖
郁蓊	鬱蓊
躍著書	躍著書
拆伙	拆夥
且于	且於
推托之词	推托之詞
采掘	採掘
九天后	九天後
药科	藥科
笑著錄	笑著錄
诸余	諸餘
𩽿	𩶰
几案	几案
刮着	刮著
纪历	紀曆
面店舖	面店舖
扎裹	紮裹
樵采	樵採
回环	迴環
中药	中藥
衣著名	衣著名
于奇庫杜克	于奇庫杜克
陈炼	陳鍊
闶	閌
于幕	於幕
舍生	捨生
看下表	看下錶
𫗠	餦
模范三軍	模范三軍
曲秀才	麴秀才
丝板	絲板
房里	房裡
趱	趲
宝历	寶曆
制著錄	制著錄
钟盘	鐘盤
采的	採的
干儿	乾兒
爰定祥历	爰定祥厤
饭庄	飯莊
斗脚	鬥腳
风卷残云	風捲殘雲
二里頭	二里頭
火拼	火拚
黏著錄	黏著錄
昂著錄	昂著錄
𩨌	𩥑
𩨏	䮳
𩨉	𩤲
𩨈	騟
𩨋	𩥄
𩨊	騚
𩨅	𩤸
𩨄	騪
抓著名	抓著名
𩨆	𩤙
𩨁	䮞
见钟不打	見鐘不打
𩨃	騝
余倍	餘倍
朱庆余	朱慶餘
１周后	１周後
摆钟	擺鐘
药线	藥線
面糊	麵糊
啷当	啷噹
管著作	管著作
开哄	開鬨
庄上	莊上
咸土	鹹土
车库里	車庫裡
應著稱	應著稱
冯	馮
幂	冪
复活节历表	復活節曆表
森林裡	森林裏
号志	號誌
鞣制	鞣製
干等	乾等
复员	複員
投药	投藥
斗分子	鬥分子
启发式	啟發式
短几	短几
牽著者	牽著者
灌药	灌藥
意占	意佔
镐	鎬
𪻐	瑽
冷庄子	冷莊子
并	並
谬采虚声	謬採虛聲
展著書	展著書
幸存	倖存
挌斗	挌鬥
广	廣
𫗴	饘
賓士	平治
志著稱	志著稱
当着	當著
一伙头	一伙頭
被发左衽	被髮左衽
淀解物	澱解物
𫗦	餔
角落里	角落裡
吐瓦魯	圖瓦盧
个中理由	箇中理由
𫗮	餭
象征	象徵
雅著名	雅著名
铸钟	鑄鐘
败于	敗於
煴	熅
发癣	髮癬
擋著錄	擋著錄
丑样	醜樣
同伙	同夥
